Time,Day of the week,CarCount,BikeCount,BusCount,TruckCount,Total
094530,Tuesday,10,0,0,0,10
094530,Tuesday,11,0,0,0,11
094530,Tuesday,11,0,0,0,11
094531,Tuesday,8,0,0,1,9
094531,Tuesday,5,0,0,2,7
094531,Tuesday,8,0,0,0,8
094531,Tuesday,8,0,0,0,8
094531,Tuesday,11,0,0,0,11
094532,Tuesday,11,0,0,0,11
094532,Tuesday,6,0,0,1,7
094532,Tuesday,5,0,0,1,6
094532,Tuesday,9,0,0,0,9
094532,Tuesday,6,0,0,2,8
094533,Tuesday,12,0,0,0,12
094533,Tuesday,11,0,0,0,11
094533,Tuesday,2,0,0,2,4
094533,Tuesday,3,0,0,2,5
094533,Tuesday,3,0,0,2,5
094534,Tuesday,11,0,0,0,11
094534,Tuesday,8,0,0,0,8
094534,Tuesday,7,0,0,0,7
094534,Tuesday,10,0,0,0,10
094534,Tuesday,9,0,0,1,10
094535,Tuesday,6,0,0,1,7
094535,Tuesday,8,0,0,1,9
094535,Tuesday,10,0,0,0,10
094535,Tuesday,2,0,0,0,2
094535,Tuesday,7,0,0,0,7
094536,Tuesday,11,0,0,0,11
094536,Tuesday,11,0,0,0,11
094536,Tuesday,7,0,0,0,7
094536,Tuesday,12,0,0,0,12
094536,Tuesday,12,0,0,0,12
094537,Tuesday,6,0,0,1,7
094537,Tuesday,11,0,0,0,11
094537,Tuesday,6,0,0,1,7
094537,Tuesday,8,0,0,0,8
094537,Tuesday,8,0,0,0,8
094538,Tuesday,9,0,0,1,10
094538,Tuesday,12,0,0,0,12
094539,Tuesday,2,0,0,1,3
094539,Tuesday,11,0,0,0,11
094540,Tuesday,4,0,0,1,5
094540,Tuesday,8,0,0,1,9
094540,Tuesday,2,0,0,0,2
094540,Tuesday,8,0,0,0,8
094540,Tuesday,5,0,0,2,7
094541,Tuesday,13,0,0,0,13
094541,Tuesday,12,0,0,0,12
094541,Tuesday,9,0,0,0,9
094541,Tuesday,7,0,0,2,9
094541,Tuesday,5,0,0,2,7
094542,Tuesday,8,0,0,1,9
094542,Tuesday,8,0,0,1,9
094542,Tuesday,11,0,0,0,11
094542,Tuesday,9,0,0,0,9
094542,Tuesday,9,0,0,0,9
094543,Tuesday,5,0,0,1,6
094543,Tuesday,10,0,0,1,11
094543,Tuesday,5,0,0,1,6
094543,Tuesday,11,0,0,0,11
094543,Tuesday,2,0,0,1,3
094544,Tuesday,6,0,0,1,7
094544,Tuesday,5,0,0,1,6
094544,Tuesday,8,0,0,1,9
094544,Tuesday,9,0,0,0,9
094544,Tuesday,11,0,0,0,11
094545,Tuesday,2,0,0,1,3
094545,Tuesday,4,0,0,0,4
094545,Tuesday,9,0,0,0,9
094545,Tuesday,10,0,0,0,10
094545,Tuesday,3,0,0,2,5
094546,Tuesday,6,0,0,1,7
094546,Tuesday,11,0,0,0,11
094546,Tuesday,7,0,0,1,8
094546,Tuesday,11,0,0,0,11
094547,Tuesday,5,0,0,1,6
094547,Tuesday,5,0,0,2,7
094547,Tuesday,7,0,0,1,8
094547,Tuesday,12,0,0,0,12
094547,Tuesday,11,0,0,0,11
094548,Tuesday,2,0,0,0,2
094548,Tuesday,7,0,0,0,7
094548,Tuesday,11,0,0,0,11
094548,Tuesday,11,0,0,0,11
094548,Tuesday,12,0,0,0,12
094549,Tuesday,9,0,0,1,10
094549,Tuesday,6,0,0,1,7
094549,Tuesday,12,0,0,0,12
094549,Tuesday,6,0,0,1,7
094549,Tuesday,3,0,0,2,5
094549,Tuesday,4,0,0,0,4
094550,Tuesday,10,0,0,0,10
094550,Tuesday,12,0,0,0,12
094550,Tuesday,6,0,0,1,7
094550,Tuesday,7,0,0,1,8
094550,Tuesday,2,0,0,2,4
094551,Tuesday,11,0,0,0,11
094551,Tuesday,3,0,0,1,4
094551,Tuesday,6,0,0,1,7
094551,Tuesday,12,0,0,0,12
094551,Tuesday,9,0,0,0,9
094552,Tuesday,8,0,0,1,9
094552,Tuesday,11,0,0,0,11
094552,Tuesday,6,0,0,1,7
094552,Tuesday,8,0,0,0,8
094552,Tuesday,11,0,0,0,11
094553,Tuesday,4,0,0,1,5
094553,Tuesday,10,0,0,0,10
094553,Tuesday,9,0,0,0,9
094553,Tuesday,12,0,0,0,12
094553,Tuesday,6,0,0,1,7
094553,Tuesday,5,0,0,1,6
094554,Tuesday,11,0,0,0,11
094554,Tuesday,5,0,0,1,6
094554,Tuesday,6,0,0,1,7
094554,Tuesday,9,0,0,1,10
094554,Tuesday,3,0,0,1,4
094555,Tuesday,6,0,0,1,7
094555,Tuesday,10,0,0,1,11
094555,Tuesday,8,0,0,1,9
094555,Tuesday,4,0,0,2,6
094555,Tuesday,7,0,0,0,7
094556,Tuesday,8,0,0,0,8
094556,Tuesday,9,0,0,0,9
094556,Tuesday,3,0,0,0,3
094556,Tuesday,12,0,0,0,12
094556,Tuesday,10,0,0,0,10
094557,Tuesday,8,0,0,1,9
094557,Tuesday,6,0,0,2,8
094557,Tuesday,9,0,0,0,9
094557,Tuesday,10,0,0,0,10
094557,Tuesday,5,0,0,2,7
094558,Tuesday,8,0,0,1,9
094558,Tuesday,6,0,0,2,8
094558,Tuesday,11,0,0,0,11
094558,Tuesday,12,0,0,0,12
094558,Tuesday,6,0,0,1,7
094559,Tuesday,3,0,0,1,4
094559,Tuesday,12,0,0,0,12
094559,Tuesday,9,0,0,0,9
094559,Tuesday,8,0,0,0,8
094559,Tuesday,6,0,0,2,8
094600,Tuesday,4,0,0,0,4
094600,Tuesday,8,0,0,0,8
094600,Tuesday,10,0,0,0,10
094600,Tuesday,8,0,0,0,8
094600,Tuesday,10,0,0,0,10
094601,Tuesday,3,0,0,2,5
094601,Tuesday,11,0,0,0,11
094601,Tuesday,6,0,0,1,7
094601,Tuesday,9,0,0,0,9
094601,Tuesday,5,0,0,2,7
094602,Tuesday,2,0,0,2,4
094602,Tuesday,2,0,0,1,3
094602,Tuesday,11,0,0,0,11
094602,Tuesday,12,0,0,0,12
094603,Tuesday,10,0,0,0,10
094603,Tuesday,11,0,0,0,11
094603,Tuesday,7,0,0,0,7
094603,Tuesday,2,0,0,1,3
094603,Tuesday,8,0,0,1,9
094604,Tuesday,3,0,0,1,4
094604,Tuesday,8,0,0,0,8
094604,Tuesday,11,0,0,0,11
094604,Tuesday,7,0,0,0,7
094604,Tuesday,6,0,0,1,7
094605,Tuesday,11,0,0,0,11
094605,Tuesday,9,0,0,0,9
094605,Tuesday,10,0,0,0,10
094605,Tuesday,6,0,0,1,7
094605,Tuesday,11,0,0,0,11
094606,Tuesday,10,0,0,0,10
094606,Tuesday,2,0,0,0,2
094606,Tuesday,7,0,0,1,8
094606,Tuesday,11,0,0,0,11
094606,Tuesday,11,0,0,0,11
094607,Tuesday,2,0,0,0,2
094607,Tuesday,7,0,0,0,7
094607,Tuesday,11,0,0,0,11
094607,Tuesday,7,0,0,0,7
094607,Tuesday,8,0,0,0,8
094608,Tuesday,11,0,0,0,11
094608,Tuesday,10,0,0,0,10
094608,Tuesday,8,0,0,0,8
094608,Tuesday,7,0,0,0,7
094609,Tuesday,10,0,0,0,10
094609,Tuesday,10,0,0,0,10
094609,Tuesday,5,0,0,1,6
094609,Tuesday,9,0,0,0,9
094609,Tuesday,11,0,0,0,11
094610,Tuesday,7,0,0,0,7
094610,Tuesday,10,0,1,0,11
094610,Tuesday,8,0,0,0,8
094610,Tuesday,5,0,0,2,7
094610,Tuesday,11,0,0,0,11
094611,Tuesday,12,0,0,0,12
094611,Tuesday,7,0,0,1,8
094611,Tuesday,9,0,0,0,9
094611,Tuesday,10,0,0,0,10
094612,Tuesday,8,0,0,0,8
094613,Tuesday,8,0,0,0,8
094613,Tuesday,10,0,0,0,10
094613,Tuesday,11,0,0,0,11
094613,Tuesday,7,0,1,1,9
094613,Tuesday,8,0,0,0,8
094614,Tuesday,8,0,0,0,8
094614,Tuesday,3,0,0,2,5
094614,Tuesday,12,0,0,0,12
094614,Tuesday,10,0,0,0,10
094615,Tuesday,3,0,0,1,4
094615,Tuesday,8,0,0,0,8
094615,Tuesday,11,0,0,1,12
094615,Tuesday,6,0,0,1,7
094615,Tuesday,11,0,0,0,11
094616,Tuesday,9,0,0,0,9
094616,Tuesday,11,0,0,0,11
094616,Tuesday,7,0,0,1,8
094616,Tuesday,9,0,0,1,10
094616,Tuesday,5,0,0,2,7
094617,Tuesday,12,0,0,0,12
094617,Tuesday,9,0,0,0,9
094617,Tuesday,3,0,0,2,5
094617,Tuesday,9,0,0,0,9
094617,Tuesday,4,0,0,0,4
094618,Tuesday,12,0,0,0,12
094618,Tuesday,8,0,0,2,10
094618,Tuesday,3,0,0,0,3
094618,Tuesday,11,0,0,0,11
094618,Tuesday,9,0,0,0,9
094619,Tuesday,9,0,0,0,9
094619,Tuesday,9,0,1,0,10
094619,Tuesday,4,0,0,0,4
094619,Tuesday,4,0,0,2,6
094619,Tuesday,8,0,0,0,8
094620,Tuesday,9,0,0,1,10
094620,Tuesday,8,0,0,0,8
094620,Tuesday,6,0,0,2,8
094620,Tuesday,3,0,0,1,4
094621,Tuesday,8,0,0,1,9
094621,Tuesday,9,0,0,0,9
094621,Tuesday,12,0,0,0,12
094621,Tuesday,6,0,0,1,7
094621,Tuesday,3,0,0,2,5
094622,Tuesday,10,0,0,0,10
094622,Tuesday,13,0,0,0,13
094622,Tuesday,2,0,0,0,2
094622,Tuesday,4,0,0,2,6
094622,Tuesday,5,0,0,1,6
094622,Tuesday,12,0,0,0,12
094623,Tuesday,3,0,0,1,4
094623,Tuesday,12,0,0,0,12
094623,Tuesday,5,0,0,2,7
094623,Tuesday,8,0,0,1,9
094623,Tuesday,7,0,0,1,8
094624,Tuesday,6,0,0,1,7
094624,Tuesday,5,0,0,1,6
094624,Tuesday,9,0,0,0,9
094624,Tuesday,10,0,0,0,10
094624,Tuesday,8,0,0,0,8
094625,Tuesday,8,0,0,1,9
094625,Tuesday,3,0,0,2,5
094625,Tuesday,12,0,0,0,12
094625,Tuesday,2,0,0,2,4
094625,Tuesday,12,0,0,0,12
094626,Tuesday,10,0,1,0,11
094626,Tuesday,5,0,0,1,6
094626,Tuesday,4,0,0,2,6
094626,Tuesday,12,0,0,0,12
094626,Tuesday,6,0,0,1,7
094627,Tuesday,11,0,0,0,11
094627,Tuesday,10,0,0,0,10
094627,Tuesday,5,0,0,2,7
094627,Tuesday,9,0,0,0,9
094627,Tuesday,8,0,0,0,8
094627,Tuesday,3,0,0,1,4
094628,Tuesday,10,0,0,0,10
094628,Tuesday,8,0,0,3,11
094628,Tuesday,11,0,0,1,12
094628,Tuesday,8,0,0,0,8
094629,Tuesday,9,0,0,0,9
094629,Tuesday,8,0,0,2,10
094629,Tuesday,5,0,0,1,6
094629,Tuesday,6,0,0,0,6
094629,Tuesday,9,0,0,0,9
094630,Tuesday,10,0,0,0,10
094630,Tuesday,3,0,0,2,5
094630,Tuesday,12,0,0,0,12
094630,Tuesday,4,0,0,0,4
094630,Tuesday,10,0,0,0,10
094631,Tuesday,10,0,0,0,10
094631,Tuesday,11,0,0,0,11
094631,Tuesday,11,0,0,0,11
094631,Tuesday,3,0,0,2,5
094631,Tuesday,11,0,0,0,11
094632,Tuesday,9,0,0,0,9
094632,Tuesday,5,0,0,0,5
094632,Tuesday,10,0,0,0,10
094632,Tuesday,5,0,0,1,6
094633,Tuesday,3,0,0,1,4
094633,Tuesday,12,0,0,0,12
094633,Tuesday,3,0,0,0,3
094633,Tuesday,11,0,0,0,11
094633,Tuesday,4,0,0,1,5
094634,Tuesday,10,0,0,0,10
094634,Tuesday,10,0,0,0,10
094634,Tuesday,8,0,0,0,8
094634,Tuesday,9,0,0,0,9
094634,Tuesday,8,0,0,0,8
094635,Tuesday,10,0,0,0,10
094635,Tuesday,10,0,0,0,10
094635,Tuesday,6,0,0,1,7
094635,Tuesday,3,0,0,0,3
094636,Tuesday,4,0,0,0,4
094636,Tuesday,11,0,0,0,11
094636,Tuesday,6,0,0,1,7
094636,Tuesday,7,0,0,0,7
094636,Tuesday,8,0,0,0,8
094637,Tuesday,11,0,0,0,11
094637,Tuesday,11,0,0,0,11
094637,Tuesday,5,0,0,1,6
094637,Tuesday,7,0,0,1,8
094637,Tuesday,5,0,0,1,6
094638,Tuesday,4,0,0,1,5
094638,Tuesday,8,0,0,1,9
094638,Tuesday,6,0,0,0,6
094638,Tuesday,10,0,0,0,10
094638,Tuesday,10,0,0,0,10
094639,Tuesday,12,0,0,0,12
094639,Tuesday,11,0,0,0,11
094639,Tuesday,2,0,0,2,4
094639,Tuesday,8,0,0,0,8
094640,Tuesday,11,0,0,0,11
094640,Tuesday,6,0,0,1,7
094640,Tuesday,8,0,0,0,8
094640,Tuesday,12,0,0,0,12
094640,Tuesday,7,0,1,1,9
094641,Tuesday,8,0,0,0,8
094641,Tuesday,10,0,0,0,10
094641,Tuesday,9,0,1,1,11
094641,Tuesday,4,0,0,0,4
094641,Tuesday,7,0,0,1,8
094642,Tuesday,4,0,0,2,6
094642,Tuesday,11,0,0,0,11
094642,Tuesday,5,0,0,2,7
094642,Tuesday,1,0,0,1,2
094643,Tuesday,11,0,0,0,11
094643,Tuesday,4,0,0,1,5
094643,Tuesday,12,0,0,0,12
094643,Tuesday,8,0,0,0,8
094643,Tuesday,11,0,0,0,11
094644,Tuesday,10,0,0,0,10
094644,Tuesday,9,0,0,0,9
094644,Tuesday,9,0,0,0,9
094644,Tuesday,11,0,0,0,11
094644,Tuesday,11,0,0,0,11
094646,Tuesday,12,0,0,0,12
094646,Tuesday,9,0,0,0,9
094646,Tuesday,9,0,0,0,9
094646,Tuesday,9,0,0,0,9
094646,Tuesday,7,0,0,0,7
094647,Tuesday,6,0,0,2,8
094647,Tuesday,3,0,0,1,4
094647,Tuesday,9,0,0,1,10
094647,Tuesday,8,0,0,0,8
094648,Tuesday,9,0,0,0,9
094648,Tuesday,3,0,0,1,4
094648,Tuesday,3,0,0,2,5
094648,Tuesday,12,0,0,0,12
094648,Tuesday,2,0,0,0,2
094649,Tuesday,9,0,0,2,11
094649,Tuesday,2,0,0,1,3
094649,Tuesday,10,0,0,0,10
094649,Tuesday,8,0,0,0,8
094650,Tuesday,10,0,0,0,10
094650,Tuesday,9,0,1,1,11
094650,Tuesday,12,0,0,0,12
094650,Tuesday,6,0,0,1,7
094650,Tuesday,9,0,0,0,9
094651,Tuesday,11,0,0,0,11
094651,Tuesday,10,0,0,1,11
094651,Tuesday,10,0,0,0,10
094651,Tuesday,8,0,0,2,10
094651,Tuesday,12,0,0,0,12
094652,Tuesday,7,0,0,1,8
094652,Tuesday,4,0,0,0,4
094652,Tuesday,9,0,0,0,9
094652,Tuesday,11,0,0,0,11
094653,Tuesday,11,0,0,0,11
094653,Tuesday,9,0,0,0,9
094653,Tuesday,9,0,0,2,11
094653,Tuesday,3,0,0,2,5
094653,Tuesday,5,0,0,1,6
094654,Tuesday,11,0,0,0,11
094654,Tuesday,1,0,0,1,2
094654,Tuesday,3,0,0,1,4
094654,Tuesday,11,0,0,0,11
094654,Tuesday,12,0,0,0,12
094655,Tuesday,9,0,0,1,10
094655,Tuesday,4,0,0,0,4
094655,Tuesday,5,0,0,1,6
094655,Tuesday,7,0,0,0,7
094655,Tuesday,10,0,0,0,10
094656,Tuesday,10,0,0,1,11
094656,Tuesday,11,0,0,0,11
094656,Tuesday,9,0,0,0,9
094656,Tuesday,10,0,0,0,10
094656,Tuesday,7,0,0,1,8
094657,Tuesday,9,0,0,1,10
094657,Tuesday,5,0,0,1,6
094657,Tuesday,11,0,0,0,11
094657,Tuesday,9,0,0,0,9
094657,Tuesday,2,0,0,1,3
094658,Tuesday,11,0,0,0,11
094658,Tuesday,3,0,0,1,4
094658,Tuesday,3,0,0,1,4
094658,Tuesday,11,0,0,0,11
094658,Tuesday,2,0,0,2,4
094659,Tuesday,2,0,0,1,3
094659,Tuesday,10,0,0,0,10
094659,Tuesday,2,0,0,2,4
094659,Tuesday,8,0,0,2,10
094659,Tuesday,7,0,0,1,8
094700,Tuesday,3,0,0,2,5
094700,Tuesday,10,0,0,0,10
094700,Tuesday,10,0,0,0,10
094700,Tuesday,10,0,0,0,10
094700,Tuesday,12,0,0,0,12
094701,Tuesday,11,0,0,0,11
094701,Tuesday,6,0,0,1,7
094701,Tuesday,4,0,0,1,5
094701,Tuesday,13,0,0,0,13
094702,Tuesday,8,0,0,1,9
094702,Tuesday,8,0,0,0,8
094702,Tuesday,9,0,0,0,9
094702,Tuesday,8,0,0,3,11
094702,Tuesday,6,0,0,1,7
094703,Tuesday,6,0,0,0,6
094703,Tuesday,11,0,0,0,11
094703,Tuesday,3,0,0,1,4
094703,Tuesday,3,0,0,0,3
094704,Tuesday,9,0,0,0,9
094704,Tuesday,10,0,0,0,10
094704,Tuesday,5,0,0,1,6
094704,Tuesday,6,0,0,1,7
094704,Tuesday,8,0,0,1,9
094705,Tuesday,4,0,0,0,4
094705,Tuesday,4,0,0,2,6
094705,Tuesday,8,0,0,0,8
094705,Tuesday,10,0,0,0,10
094705,Tuesday,12,0,0,0,12
094706,Tuesday,11,0,0,0,11
094706,Tuesday,7,0,0,2,9
094706,Tuesday,7,0,0,2,9
094706,Tuesday,10,0,0,0,10
094706,Tuesday,6,0,0,0,6
094707,Tuesday,12,0,0,0,12
094707,Tuesday,11,0,0,0,11
094707,Tuesday,10,0,0,0,10
094707,Tuesday,8,0,0,0,8
094708,Tuesday,9,0,0,0,9
094708,Tuesday,12,0,0,0,12
094708,Tuesday,7,0,0,0,7
094708,Tuesday,11,0,0,0,11
094708,Tuesday,12,0,0,0,12
094709,Tuesday,12,0,0,0,12
094709,Tuesday,11,0,0,0,11
094709,Tuesday,12,0,0,0,12
094709,Tuesday,10,0,1,0,11
094709,Tuesday,12,0,0,0,12
094710,Tuesday,2,0,0,2,4
094710,Tuesday,10,0,0,0,10
094710,Tuesday,5,0,0,1,6
094710,Tuesday,7,0,0,0,7
094711,Tuesday,3,0,0,1,4
094711,Tuesday,6,0,0,2,8
094711,Tuesday,5,0,0,1,6
094711,Tuesday,10,0,0,0,10
094711,Tuesday,9,0,0,1,10
094712,Tuesday,6,0,0,1,7
094712,Tuesday,13,0,0,0,13
094712,Tuesday,9,0,0,1,10
094712,Tuesday,10,0,0,0,10
094713,Tuesday,6,0,0,1,7
094713,Tuesday,12,0,0,0,12
094713,Tuesday,4,0,0,0,4
094713,Tuesday,9,0,0,1,10
094713,Tuesday,2,0,0,2,4
094714,Tuesday,12,0,0,0,12
094714,Tuesday,10,0,0,0,10
094714,Tuesday,11,0,0,0,11
094714,Tuesday,4,0,0,0,4
094714,Tuesday,5,0,0,2,7
094715,Tuesday,9,0,0,0,9
094715,Tuesday,11,0,0,0,11
094715,Tuesday,9,0,0,0,9
094715,Tuesday,8,0,0,0,8
094715,Tuesday,11,0,0,0,11
094716,Tuesday,10,0,0,0,10
094716,Tuesday,2,0,0,0,2
094716,Tuesday,12,0,0,0,12
094716,Tuesday,10,0,0,0,10
094717,Tuesday,5,0,0,0,5
094717,Tuesday,10,0,0,0,10
094717,Tuesday,5,0,0,0,5
094717,Tuesday,10,0,0,0,10
094717,Tuesday,2,0,0,1,3
094718,Tuesday,10,0,0,0,10
094719,Tuesday,11,0,0,0,11
094719,Tuesday,8,0,0,1,9
094719,Tuesday,10,0,0,0,10
094720,Tuesday,3,0,0,1,4
094720,Tuesday,7,0,0,0,7
094720,Tuesday,10,0,0,0,10
094720,Tuesday,2,0,0,0,2
094720,Tuesday,9,0,0,0,9
094721,Tuesday,8,0,0,0,8
094721,Tuesday,8,0,0,0,8
094721,Tuesday,9,0,0,0,9
094721,Tuesday,5,0,0,2,7
094722,Tuesday,11,0,0,0,11
094722,Tuesday,2,0,0,1,3
094722,Tuesday,9,0,0,0,9
094722,Tuesday,8,0,0,0,8
094722,Tuesday,8,0,0,0,8
094723,Tuesday,3,0,0,1,4
094723,Tuesday,2,0,0,2,4
094723,Tuesday,8,0,0,0,8
094723,Tuesday,4,0,0,0,4
094724,Tuesday,9,0,0,0,9
094724,Tuesday,2,0,0,0,2
094724,Tuesday,6,0,0,1,7
094724,Tuesday,10,0,0,1,11
094724,Tuesday,9,0,0,0,9
094725,Tuesday,9,0,0,0,9
094725,Tuesday,3,0,0,1,4
094725,Tuesday,10,0,0,0,10
094725,Tuesday,13,0,0,0,13
094726,Tuesday,8,0,0,3,11
094726,Tuesday,10,0,0,0,10
094726,Tuesday,8,0,0,0,8
094726,Tuesday,12,0,0,0,12
094726,Tuesday,3,0,0,1,4
094727,Tuesday,10,0,0,0,10
094727,Tuesday,8,0,0,0,8
094727,Tuesday,6,0,0,1,7
094727,Tuesday,11,0,0,0,11
094727,Tuesday,7,0,0,0,7
094728,Tuesday,11,0,0,0,11
094728,Tuesday,9,0,0,1,10
094728,Tuesday,3,0,0,1,4
094728,Tuesday,5,0,0,1,6
094728,Tuesday,6,0,0,1,7
094729,Tuesday,8,0,0,0,8
094729,Tuesday,2,0,0,0,2
094729,Tuesday,11,0,0,0,11
094729,Tuesday,2,0,0,1,3
094729,Tuesday,8,0,0,1,9
094730,Tuesday,12,0,0,0,12
094730,Tuesday,8,0,0,0,8
094730,Tuesday,9,0,1,0,10
094730,Tuesday,6,0,0,2,8
094730,Tuesday,10,0,0,0,10
094731,Tuesday,10,0,1,0,11
094731,Tuesday,9,0,0,0,9
094731,Tuesday,8,0,0,0,8
094731,Tuesday,7,0,0,1,8
094732,Tuesday,9,0,0,0,9
094732,Tuesday,7,0,0,2,9
094732,Tuesday,9,0,0,1,10
094732,Tuesday,9,0,0,1,10
094732,Tuesday,6,0,0,1,7
094733,Tuesday,9,0,0,0,9
094733,Tuesday,11,0,0,0,11
094733,Tuesday,7,0,0,0,7
094733,Tuesday,7,0,0,0,7
094733,Tuesday,3,0,0,1,4
094734,Tuesday,8,0,0,0,8
094734,Tuesday,12,0,0,0,12
094734,Tuesday,7,0,0,0,7
094734,Tuesday,10,0,0,0,10
094734,Tuesday,10,0,0,0,10
094735,Tuesday,4,0,0,0,4
094735,Tuesday,3,0,0,1,4
094735,Tuesday,2,0,0,2,4
094735,Tuesday,8,0,0,1,9
094735,Tuesday,7,0,0,0,7
094736,Tuesday,9,0,0,0,9
094736,Tuesday,8,0,1,0,9
094736,Tuesday,13,0,0,0,13
094736,Tuesday,12,0,0,0,12
094736,Tuesday,7,0,0,0,7
094737,Tuesday,10,0,0,0,10
094737,Tuesday,9,0,0,0,9
094737,Tuesday,8,0,0,0,8
094737,Tuesday,11,0,0,0,11
094738,Tuesday,11,0,0,0,11
094738,Tuesday,3,0,0,0,3
094738,Tuesday,8,0,0,0,8
094738,Tuesday,8,0,0,0,8
094738,Tuesday,8,0,0,1,9
094739,Tuesday,9,0,0,0,9
094739,Tuesday,11,0,0,0,11
094739,Tuesday,7,0,0,0,7
094739,Tuesday,12,0,0,0,12
094739,Tuesday,12,0,0,0,12
094740,Tuesday,9,0,0,1,10
094740,Tuesday,10,0,0,0,10
094740,Tuesday,8,0,0,0,8
094740,Tuesday,7,0,0,0,7
094740,Tuesday,3,0,0,1,4
094741,Tuesday,10,0,0,0,10
094741,Tuesday,11,0,0,0,11
094741,Tuesday,5,0,0,0,5
094741,Tuesday,9,0,0,0,9
094742,Tuesday,8,0,0,0,8
094742,Tuesday,8,0,0,0,8
094742,Tuesday,7,0,0,1,8
094742,Tuesday,7,0,0,0,7
094742,Tuesday,9,0,0,0,9
094743,Tuesday,8,0,0,0,8
094743,Tuesday,7,0,0,0,7
094743,Tuesday,9,0,0,0,9
094743,Tuesday,12,0,0,0,12
094744,Tuesday,9,0,0,0,9
094744,Tuesday,9,0,0,0,9
094744,Tuesday,7,0,0,0,7
094744,Tuesday,11,0,0,0,11
094744,Tuesday,11,0,0,0,11
094745,Tuesday,5,0,0,0,5
094745,Tuesday,11,0,0,0,11
094745,Tuesday,10,0,1,1,12
094745,Tuesday,3,0,0,2,5
094745,Tuesday,9,0,0,0,9
094746,Tuesday,4,0,0,0,4
094746,Tuesday,10,0,0,0,10
094746,Tuesday,10,0,0,0,10
094746,Tuesday,10,0,0,0,10
094747,Tuesday,12,0,0,0,12
094747,Tuesday,10,0,0,0,10
094747,Tuesday,6,0,0,1,7
094747,Tuesday,6,0,0,2,8
094747,Tuesday,3,0,0,2,5
094748,Tuesday,8,0,0,0,8
094748,Tuesday,6,0,0,0,6
094748,Tuesday,12,0,0,0,12
094748,Tuesday,11,0,0,0,11
094749,Tuesday,9,0,0,1,10
094749,Tuesday,7,0,0,2,9
094749,Tuesday,9,0,0,0,9
094749,Tuesday,3,0,0,2,5
094749,Tuesday,9,0,0,0,9
094750,Tuesday,7,0,0,2,9
094750,Tuesday,10,0,0,0,10
094750,Tuesday,3,0,0,0,3
094750,Tuesday,11,0,0,0,11
094751,Tuesday,11,0,0,0,11
094751,Tuesday,6,0,0,2,8
094751,Tuesday,2,0,0,2,4
094752,Tuesday,11,0,0,0,11
094752,Tuesday,2,0,0,0,2
094753,Tuesday,9,0,0,1,10
094753,Tuesday,10,0,0,0,10
094753,Tuesday,8,0,0,0,8
094753,Tuesday,4,0,0,1,5
094754,Tuesday,8,0,0,0,8
094754,Tuesday,11,0,0,0,11
094754,Tuesday,12,0,0,0,12
094754,Tuesday,11,0,0,0,11
094754,Tuesday,11,0,0,0,11
094755,Tuesday,3,0,0,1,4
094755,Tuesday,3,0,0,1,4
094755,Tuesday,3,0,0,1,4
094755,Tuesday,9,0,0,0,9
094756,Tuesday,11,0,0,0,11
094756,Tuesday,13,0,0,0,13
094756,Tuesday,9,0,0,0,9
094756,Tuesday,11,0,0,0,11
094756,Tuesday,12,0,0,0,12
094757,Tuesday,8,0,0,1,9
094757,Tuesday,9,0,0,0,9
094757,Tuesday,2,0,0,2,4
094757,Tuesday,8,0,0,0,8
094758,Tuesday,3,0,0,1,4
094758,Tuesday,2,0,0,1,3
094758,Tuesday,12,0,0,0,12
094758,Tuesday,10,0,1,1,12
094758,Tuesday,11,0,0,0,11
094759,Tuesday,11,0,0,0,11
094759,Tuesday,9,0,0,0,9
094759,Tuesday,12,0,0,0,12
094759,Tuesday,7,0,0,2,9
094800,Tuesday,2,0,0,1,3
094800,Tuesday,3,0,0,2,5
094800,Tuesday,11,0,0,0,11
094800,Tuesday,5,0,0,1,6
094800,Tuesday,7,0,0,0,7
094801,Tuesday,4,0,0,0,4
094801,Tuesday,6,0,0,1,7
094801,Tuesday,9,0,1,0,10
094801,Tuesday,10,0,0,0,10
094801,Tuesday,6,0,0,1,7
094802,Tuesday,4,0,0,0,4
094802,Tuesday,10,0,0,0,10
094802,Tuesday,9,0,0,1,10
094802,Tuesday,2,0,0,2,4
094802,Tuesday,8,0,0,0,8
094803,Tuesday,12,0,0,0,12
094803,Tuesday,10,0,0,0,10
094803,Tuesday,9,0,0,0,9
094803,Tuesday,10,0,0,0,10
094803,Tuesday,10,0,0,0,10
094804,Tuesday,10,0,0,0,10
094804,Tuesday,7,0,0,0,7
094804,Tuesday,12,0,0,0,12
094804,Tuesday,10,0,0,0,10
094804,Tuesday,2,0,0,2,4
094805,Tuesday,7,0,0,0,7
094805,Tuesday,4,0,0,1,5
094805,Tuesday,8,0,0,0,8
094805,Tuesday,11,0,0,0,11
094805,Tuesday,8,0,0,1,9
094806,Tuesday,8,0,0,1,9
094806,Tuesday,9,0,0,0,9
094806,Tuesday,11,0,0,0,11
094806,Tuesday,3,0,0,2,5
094806,Tuesday,10,0,0,0,10
094807,Tuesday,12,0,0,0,12
094807,Tuesday,6,0,0,0,6
094807,Tuesday,3,0,0,1,4
094807,Tuesday,8,0,0,0,8
094808,Tuesday,11,0,0,0,11
094808,Tuesday,4,0,0,0,4
094808,Tuesday,13,0,0,0,13
094808,Tuesday,8,0,0,0,8
094808,Tuesday,12,0,0,0,12
094809,Tuesday,8,0,0,0,8
094809,Tuesday,5,0,0,1,6
094809,Tuesday,7,0,0,2,9
094809,Tuesday,5,0,0,2,7
094809,Tuesday,9,0,0,0,9
094810,Tuesday,6,0,0,1,7
094810,Tuesday,10,0,0,0,10
094810,Tuesday,10,0,0,0,10
094810,Tuesday,13,0,0,0,13
094810,Tuesday,5,0,0,2,7
094811,Tuesday,11,0,0,0,11
094811,Tuesday,2,0,0,2,4
094811,Tuesday,12,0,0,0,12
094811,Tuesday,6,0,0,1,7
094811,Tuesday,9,0,0,0,9
094812,Tuesday,8,0,0,2,10
094812,Tuesday,12,0,0,0,12
094812,Tuesday,7,0,0,2,9
094812,Tuesday,11,0,0,0,11
094813,Tuesday,5,0,0,1,6
094813,Tuesday,9,0,0,0,9
094813,Tuesday,5,0,0,1,6
094813,Tuesday,10,0,0,0,10
094813,Tuesday,12,0,0,0,12
094814,Tuesday,3,0,0,0,3
094814,Tuesday,11,0,0,0,11
094814,Tuesday,11,0,0,0,11
094814,Tuesday,9,0,0,1,10
094814,Tuesday,8,0,0,1,9
094815,Tuesday,8,0,0,0,8
094815,Tuesday,9,0,0,0,9
094815,Tuesday,10,0,0,0,10
094815,Tuesday,10,0,0,0,10
094816,Tuesday,6,0,0,2,8
094816,Tuesday,11,0,0,0,11
094816,Tuesday,11,0,0,0,11
094816,Tuesday,11,0,0,0,11
094816,Tuesday,11,0,0,0,11
094817,Tuesday,2,0,0,2,4
094817,Tuesday,3,0,0,1,4
094817,Tuesday,7,0,0,2,9
094817,Tuesday,10,0,0,0,10
094817,Tuesday,11,0,0,1,12
094818,Tuesday,6,0,0,0,6
094818,Tuesday,2,0,0,2,4
094818,Tuesday,7,0,0,0,7
094818,Tuesday,8,0,0,1,9
094818,Tuesday,10,0,0,0,10
094819,Tuesday,6,0,0,1,7
094819,Tuesday,10,0,0,0,10
094819,Tuesday,11,0,0,0,11
094819,Tuesday,10,0,0,0,10
094820,Tuesday,10,0,0,0,10
094820,Tuesday,12,0,0,0,12
094820,Tuesday,12,0,0,0,12
094820,Tuesday,4,0,0,1,5
094820,Tuesday,10,0,0,0,10
094821,Tuesday,7,0,0,0,7
094821,Tuesday,10,0,0,0,10
094821,Tuesday,3,0,0,1,4
094821,Tuesday,3,0,0,1,4
094821,Tuesday,11,0,0,0,11
094822,Tuesday,11,0,0,0,11
094822,Tuesday,3,0,0,2,5
094822,Tuesday,2,0,0,0,2
094822,Tuesday,13,0,0,0,13
094823,Tuesday,10,0,0,0,10
094823,Tuesday,2,0,0,1,3
094823,Tuesday,7,0,0,0,7
094823,Tuesday,8,0,0,0,8
094823,Tuesday,8,0,0,0,8
094824,Tuesday,6,0,0,1,7
094824,Tuesday,9,0,0,0,9
094824,Tuesday,6,0,0,1,7
094824,Tuesday,8,0,0,0,8
094826,Tuesday,9,0,0,0,9
094826,Tuesday,6,0,0,1,7
094826,Tuesday,6,0,0,1,7
094826,Tuesday,9,0,0,0,9
094826,Tuesday,10,0,0,0,10
094827,Tuesday,6,0,0,1,7
094827,Tuesday,10,0,0,0,10
094827,Tuesday,8,0,0,0,8
094827,Tuesday,4,0,0,2,6
094828,Tuesday,9,0,0,0,9
094828,Tuesday,7,0,0,0,7
094828,Tuesday,10,0,0,0,10
094828,Tuesday,11,0,0,0,11
094828,Tuesday,10,0,0,0,10
094829,Tuesday,7,0,0,1,8
094829,Tuesday,11,0,0,0,11
094829,Tuesday,10,0,0,0,10
094829,Tuesday,11,0,0,0,11
094829,Tuesday,7,0,0,0,7
094830,Tuesday,8,0,0,0,8
094830,Tuesday,3,0,0,0,3
094830,Tuesday,4,0,0,2,6
094830,Tuesday,8,0,0,0,8
094831,Tuesday,8,0,0,0,8
094831,Tuesday,8,0,0,0,8
094831,Tuesday,8,0,0,0,8
094831,Tuesday,3,0,0,2,5
094831,Tuesday,9,0,0,0,9
094832,Tuesday,10,0,0,0,10
094832,Tuesday,4,0,0,0,4
094832,Tuesday,11,0,0,0,11
094832,Tuesday,8,0,0,1,9
094833,Tuesday,4,0,0,1,5
094833,Tuesday,6,0,0,1,7
094833,Tuesday,4,0,0,2,6
094833,Tuesday,3,0,0,1,4
094833,Tuesday,12,0,0,0,12
094834,Tuesday,9,0,0,0,9
094834,Tuesday,4,0,0,1,5
094834,Tuesday,9,0,0,0,9
094834,Tuesday,7,0,0,1,8
094834,Tuesday,9,0,0,1,10
094835,Tuesday,4,0,0,0,4
094835,Tuesday,3,0,0,2,5
094835,Tuesday,10,0,0,0,10
094835,Tuesday,2,0,0,0,2
094835,Tuesday,10,0,1,0,11
094836,Tuesday,3,0,0,2,5
094836,Tuesday,10,0,0,0,10
094836,Tuesday,11,0,0,0,11
094836,Tuesday,11,0,0,0,11
094836,Tuesday,2,0,0,0,2
094837,Tuesday,10,0,0,0,10
094837,Tuesday,11,0,0,0,11
094837,Tuesday,10,0,0,0,10
094837,Tuesday,8,0,0,1,9
094837,Tuesday,9,0,0,0,9
094838,Tuesday,3,0,0,1,4
094838,Tuesday,7,0,0,0,7
094838,Tuesday,11,0,0,0,11
094838,Tuesday,2,0,0,1,3
094838,Tuesday,8,0,0,0,8
094839,Tuesday,5,0,0,1,6
094839,Tuesday,7,0,0,1,8
094839,Tuesday,7,0,0,1,8
094839,Tuesday,5,0,0,2,7
094839,Tuesday,8,0,0,0,8
094840,Tuesday,2,0,0,0,2
094840,Tuesday,10,0,0,0,10
094840,Tuesday,7,0,0,0,7
094840,Tuesday,11,0,0,0,11
094840,Tuesday,10,0,0,0,10
094841,Tuesday,11,0,0,0,11
094841,Tuesday,11,0,0,0,11
094841,Tuesday,11,0,0,0,11
094841,Tuesday,10,0,0,0,10
094842,Tuesday,5,0,0,1,6
094842,Tuesday,8,0,0,0,8
094842,Tuesday,10,0,0,0,10
094842,Tuesday,11,0,0,0,11
094842,Tuesday,3,0,0,2,5
094843,Tuesday,10,0,0,0,10
094843,Tuesday,10,0,0,0,10
094843,Tuesday,7,0,0,0,7
094843,Tuesday,9,0,0,0,9
094843,Tuesday,9,0,0,0,9
094844,Tuesday,9,0,0,0,9
094844,Tuesday,9,0,0,0,9
094844,Tuesday,9,0,0,0,9
094844,Tuesday,5,0,0,1,6
094844,Tuesday,8,0,0,1,9
094845,Tuesday,8,0,0,0,8
094845,Tuesday,5,0,0,1,6
094845,Tuesday,11,0,0,0,11
094845,Tuesday,9,0,0,1,10
094845,Tuesday,11,0,0,0,11
094846,Tuesday,10,0,0,0,10
094846,Tuesday,7,0,0,1,8
094846,Tuesday,3,0,0,1,4
094846,Tuesday,9,0,0,0,9
094846,Tuesday,11,0,0,0,11
094847,Tuesday,7,0,0,0,7
094847,Tuesday,3,0,0,1,4
094847,Tuesday,7,0,0,0,7
094847,Tuesday,3,0,0,1,4
094847,Tuesday,12,0,0,0,12
094848,Tuesday,13,0,0,0,13
094848,Tuesday,3,0,0,0,3
094848,Tuesday,9,0,0,0,9
094848,Tuesday,7,0,0,1,8
094849,Tuesday,9,0,0,0,9
094849,Tuesday,9,0,0,2,11
094849,Tuesday,2,0,0,0,2
094849,Tuesday,6,0,0,0,6
094849,Tuesday,8,0,0,0,8
094850,Tuesday,9,0,0,0,9
094850,Tuesday,8,0,0,1,9
094850,Tuesday,11,0,0,0,11
094850,Tuesday,9,0,0,0,9
094850,Tuesday,9,0,0,0,9
094851,Tuesday,3,0,0,0,3
094851,Tuesday,10,0,0,0,10
094851,Tuesday,10,0,0,0,10
094851,Tuesday,13,0,0,0,13
094852,Tuesday,13,0,0,0,13
094852,Tuesday,8,0,0,1,9
094852,Tuesday,10,0,0,0,10
094852,Tuesday,7,0,0,0,7
094852,Tuesday,3,0,0,2,5
094853,Tuesday,7,0,0,1,8
094853,Tuesday,11,0,0,0,11
094853,Tuesday,2,0,0,1,3
094853,Tuesday,12,0,0,0,12
094853,Tuesday,10,0,0,0,10
094854,Tuesday,7,0,0,0,7
094854,Tuesday,7,0,0,2,9
094854,Tuesday,12,0,0,0,12
094854,Tuesday,11,0,0,0,11
094854,Tuesday,2,0,0,0,2
094855,Tuesday,11,0,0,0,11
094855,Tuesday,10,0,0,0,10
094855,Tuesday,5,0,0,2,7
094855,Tuesday,9,0,0,0,9
094856,Tuesday,6,0,0,1,7
094856,Tuesday,10,0,0,0,10
094856,Tuesday,6,0,0,1,7
094856,Tuesday,7,0,0,0,7
094856,Tuesday,13,0,0,0,13
094857,Tuesday,8,0,0,1,9
094857,Tuesday,2,0,0,1,3
094857,Tuesday,8,0,0,0,8
094857,Tuesday,8,0,0,0,8
094857,Tuesday,9,0,0,1,10
094858,Tuesday,5,0,0,0,5
094859,Tuesday,12,0,0,0,12
094859,Tuesday,3,0,0,1,4
094859,Tuesday,11,0,0,0,11
094900,Tuesday,11,0,0,1,12
094900,Tuesday,4,0,0,0,4
094900,Tuesday,11,0,0,0,11
094900,Tuesday,4,0,0,2,6
094900,Tuesday,9,0,0,0,9
094901,Tuesday,6,0,0,2,8
094901,Tuesday,12,0,0,0,12
094901,Tuesday,10,0,0,0,10
094901,Tuesday,10,0,0,0,10
094902,Tuesday,12,0,0,0,12
094902,Tuesday,9,0,0,0,9
094902,Tuesday,7,0,0,0,7
094902,Tuesday,9,0,0,0,9
094902,Tuesday,9,0,0,0,9
094903,Tuesday,8,0,0,0,8
094903,Tuesday,5,0,0,1,6
094903,Tuesday,9,0,0,0,9
094903,Tuesday,11,0,0,0,11
094903,Tuesday,12,0,0,0,12
094904,Tuesday,10,0,0,0,10
094904,Tuesday,12,0,0,0,12
094904,Tuesday,11,0,0,0,11
094904,Tuesday,12,0,0,0,12
094904,Tuesday,7,0,0,0,7
094905,Tuesday,7,0,0,0,7
094905,Tuesday,11,0,0,0,11
094905,Tuesday,12,0,0,0,12
094905,Tuesday,8,0,0,2,10
094906,Tuesday,11,0,0,0,11
094906,Tuesday,12,0,0,0,12
094906,Tuesday,3,0,0,1,4
094906,Tuesday,11,0,0,0,11
094906,Tuesday,8,0,0,1,9
094907,Tuesday,9,0,0,0,9
094907,Tuesday,12,0,0,0,12
094907,Tuesday,10,0,0,0,10
094907,Tuesday,11,0,0,0,11
094907,Tuesday,9,0,0,0,9
094908,Tuesday,12,0,0,0,12
094908,Tuesday,8,0,0,0,8
094908,Tuesday,11,0,0,0,11
094908,Tuesday,6,0,0,1,7
094908,Tuesday,8,0,0,0,8
094909,Tuesday,12,0,0,0,12
094909,Tuesday,10,0,0,0,10
094909,Tuesday,9,0,0,0,9
094909,Tuesday,7,0,0,1,8
094909,Tuesday,11,0,0,0,11
094909,Tuesday,10,0,0,0,10
094910,Tuesday,4,0,0,1,5
094910,Tuesday,5,0,0,1,6
094910,Tuesday,11,0,0,0,11
094910,Tuesday,11,0,0,0,11
094910,Tuesday,10,0,0,0,10
094911,Tuesday,6,0,0,1,7
094911,Tuesday,3,0,0,1,4
094911,Tuesday,11,0,0,0,11
094911,Tuesday,7,0,0,0,7
094911,Tuesday,12,0,0,0,12
094912,Tuesday,12,0,0,0,12
094912,Tuesday,10,0,0,0,10
094912,Tuesday,12,0,0,0,12
094912,Tuesday,11,0,0,0,11
094912,Tuesday,9,0,0,1,10
094913,Tuesday,10,0,0,0,10
094913,Tuesday,12,0,0,0,12
094913,Tuesday,11,0,0,0,11
094913,Tuesday,10,0,0,0,10
094913,Tuesday,7,0,0,0,7
094914,Tuesday,2,0,0,0,2
094914,Tuesday,7,0,0,0,7
094914,Tuesday,3,0,0,2,5
094914,Tuesday,8,0,0,0,8
094914,Tuesday,8,0,0,0,8
094915,Tuesday,11,0,0,0,11
094915,Tuesday,10,0,0,0,10
094915,Tuesday,4,0,0,1,5
094915,Tuesday,11,0,0,0,11
094915,Tuesday,10,0,0,0,10
094916,Tuesday,11,0,0,0,11
094916,Tuesday,3,0,0,1,4
094916,Tuesday,9,0,0,0,9
094916,Tuesday,12,0,0,0,12
094916,Tuesday,3,0,0,2,5
094917,Tuesday,11,0,0,0,11
094917,Tuesday,1,0,0,1,2
094917,Tuesday,3,0,0,1,4
094917,Tuesday,7,0,0,1,8
094917,Tuesday,4,0,0,1,5
094918,Tuesday,10,0,0,0,10
094918,Tuesday,9,0,0,0,9
094918,Tuesday,9,0,0,1,10
094918,Tuesday,12,0,0,0,12
094918,Tuesday,7,0,0,3,10
094919,Tuesday,11,0,0,0,11
094919,Tuesday,8,0,0,0,8
094919,Tuesday,11,0,0,0,11
094919,Tuesday,6,0,0,1,7
094919,Tuesday,11,0,0,0,11
094920,Tuesday,5,0,0,0,5
094920,Tuesday,9,0,0,0,9
094920,Tuesday,12,0,0,0,12
094920,Tuesday,7,0,0,1,8
094920,Tuesday,2,0,0,1,3
094921,Tuesday,8,0,0,0,8
094921,Tuesday,9,0,0,0,9
094921,Tuesday,7,0,0,1,8
094921,Tuesday,7,0,0,0,7
094921,Tuesday,10,0,0,0,10
094922,Tuesday,11,0,0,0,11
094922,Tuesday,9,0,0,0,9
094922,Tuesday,6,0,0,1,7
094922,Tuesday,13,0,0,0,13
094922,Tuesday,9,0,0,0,9
094923,Tuesday,6,0,0,1,7
094923,Tuesday,6,0,0,0,6
094923,Tuesday,9,0,0,1,10
094923,Tuesday,7,0,0,1,8
094923,Tuesday,2,0,0,0,2
094924,Tuesday,2,0,0,1,3
094924,Tuesday,4,0,0,0,4
094924,Tuesday,10,0,0,0,10
094924,Tuesday,7,0,0,1,8
094925,Tuesday,6,0,0,1,7
094925,Tuesday,9,0,0,2,11
094925,Tuesday,10,0,0,0,10
094925,Tuesday,8,0,0,1,9
094925,Tuesday,7,0,0,0,7
094926,Tuesday,2,0,0,1,3
094926,Tuesday,7,0,0,0,7
094926,Tuesday,10,0,0,0,10
094926,Tuesday,11,0,0,0,11
094926,Tuesday,7,0,0,2,9
094927,Tuesday,1,0,0,2,3
094927,Tuesday,13,0,0,0,13
094927,Tuesday,1,0,0,0,1
094927,Tuesday,10,0,0,0,10
094927,Tuesday,10,0,0,0,10
094928,Tuesday,8,0,0,0,8
094928,Tuesday,10,0,0,0,10
094928,Tuesday,11,0,0,0,11
094928,Tuesday,12,0,0,0,12
094929,Tuesday,6,0,0,1,7
094929,Tuesday,9,0,0,0,9
094929,Tuesday,12,0,0,0,12
094929,Tuesday,6,0,0,2,8
094929,Tuesday,9,0,0,0,9
094930,Tuesday,9,0,0,0,9
094930,Tuesday,2,0,0,1,3
094930,Tuesday,12,0,0,0,12
094930,Tuesday,4,0,0,0,4
094930,Tuesday,11,0,0,0,11
094931,Tuesday,5,0,0,1,6
094931,Tuesday,5,0,0,0,5
094931,Tuesday,10,0,0,0,10
094932,Tuesday,12,0,0,0,12
094933,Tuesday,5,0,0,1,6
094933,Tuesday,11,0,0,0,11
094933,Tuesday,9,0,0,0,9
094933,Tuesday,3,0,0,2,5
094933,Tuesday,12,0,0,0,12
094934,Tuesday,5,0,0,1,6
094934,Tuesday,9,0,0,0,9
094934,Tuesday,5,0,0,1,6
094934,Tuesday,4,0,0,0,4
094935,Tuesday,11,0,0,0,11
094935,Tuesday,4,0,0,1,5
094935,Tuesday,11,0,0,0,11
094935,Tuesday,10,0,0,0,10
094935,Tuesday,6,0,0,1,7
094936,Tuesday,11,0,0,0,11
094936,Tuesday,10,0,0,0,10
094936,Tuesday,10,0,0,0,10
094936,Tuesday,11,0,0,0,11
094936,Tuesday,8,0,0,0,8
094937,Tuesday,4,0,0,0,4
094937,Tuesday,10,0,0,0,10
094937,Tuesday,11,0,0,0,11
094937,Tuesday,11,0,0,0,11
094937,Tuesday,13,0,0,0,13
094938,Tuesday,8,0,0,0,8
094938,Tuesday,8,0,0,0,8
094938,Tuesday,11,0,0,0,11
094938,Tuesday,5,0,0,1,6
094939,Tuesday,10,0,0,0,10
094939,Tuesday,3,0,0,1,4
094939,Tuesday,5,0,0,1,6
094939,Tuesday,11,0,0,0,11
094939,Tuesday,10,0,0,0,10
094940,Tuesday,7,0,0,0,7
094940,Tuesday,11,0,0,0,11
094940,Tuesday,7,0,0,0,7
094940,Tuesday,9,0,0,0,9
094940,Tuesday,9,0,0,0,9
094941,Tuesday,8,0,0,0,8
094941,Tuesday,11,0,0,0,11
094941,Tuesday,7,0,0,0,7
094941,Tuesday,4,0,0,0,4
094941,Tuesday,10,0,0,0,10
094942,Tuesday,10,0,0,0,10
094942,Tuesday,11,0,0,0,11
094942,Tuesday,3,0,0,1,4
094942,Tuesday,8,0,0,0,8
094942,Tuesday,6,0,0,1,7
094943,Tuesday,10,0,0,0,10
094943,Tuesday,11,0,0,0,11
094943,Tuesday,3,0,0,1,4
094943,Tuesday,3,0,0,0,3
094943,Tuesday,8,0,0,0,8
094944,Tuesday,3,0,0,2,5
094944,Tuesday,11,0,0,0,11
094944,Tuesday,4,0,0,1,5
094944,Tuesday,12,0,0,0,12
094944,Tuesday,9,0,0,0,9
094945,Tuesday,10,0,1,0,11
094945,Tuesday,2,0,0,0,2
094945,Tuesday,3,0,0,1,4
094945,Tuesday,9,0,0,0,9
094945,Tuesday,11,0,0,0,11
094946,Tuesday,10,0,0,0,10
094946,Tuesday,11,0,0,0,11
094946,Tuesday,11,0,0,0,11
094946,Tuesday,2,0,0,0,2
094946,Tuesday,10,0,0,0,10
094947,Tuesday,11,0,0,1,12
094947,Tuesday,10,0,0,0,10
094947,Tuesday,12,0,0,0,12
094947,Tuesday,12,0,0,0,12
094948,Tuesday,8,0,0,1,9
094948,Tuesday,11,0,0,0,11
094948,Tuesday,9,0,0,1,10
094949,Tuesday,4,0,0,0,4
094949,Tuesday,8,0,0,1,9
094949,Tuesday,7,0,0,2,9
094950,Tuesday,7,0,0,0,7
094950,Tuesday,10,0,0,0,10
094950,Tuesday,10,0,1,0,11
094951,Tuesday,9,0,0,0,9
094951,Tuesday,13,0,0,0,13
094951,Tuesday,9,0,0,0,9
094951,Tuesday,10,0,1,0,11
094952,Tuesday,8,0,0,0,8
094952,Tuesday,7,0,0,2,9
094952,Tuesday,9,0,0,0,9
094952,Tuesday,5,0,0,2,7
094953,Tuesday,7,0,0,0,7
094953,Tuesday,3,0,0,0,3
094953,Tuesday,12,0,0,0,12
094954,Tuesday,12,0,0,0,12
094954,Tuesday,2,0,0,0,2
094954,Tuesday,4,0,0,1,5
094954,Tuesday,11,0,0,0,11
094955,Tuesday,7,0,0,1,8
094955,Tuesday,11,0,0,0,11
094955,Tuesday,8,0,0,0,8
094956,Tuesday,8,0,0,3,11
094956,Tuesday,7,0,0,0,7
094956,Tuesday,12,0,0,0,12
094956,Tuesday,9,0,0,0,9
094957,Tuesday,10,0,0,0,10
094957,Tuesday,8,0,0,2,10
094957,Tuesday,4,0,0,1,5
094957,Tuesday,12,0,0,0,12
094958,Tuesday,8,0,0,0,8
094958,Tuesday,8,0,0,0,8
094958,Tuesday,7,0,0,0,7
094958,Tuesday,5,0,0,2,7
094959,Tuesday,2,0,0,1,3
094959,Tuesday,7,0,0,1,8
094959,Tuesday,10,0,0,0,10
094959,Tuesday,9,0,0,0,9
095000,Tuesday,10,0,0,0,10
095000,Tuesday,10,0,0,0,10
095000,Tuesday,11,0,0,0,11
095000,Tuesday,9,0,0,1,10
095001,Tuesday,9,0,0,0,9
095001,Tuesday,10,0,0,0,10
095001,Tuesday,11,0,0,0,11
095001,Tuesday,8,0,0,2,10
095002,Tuesday,3,0,0,1,4
095002,Tuesday,5,0,0,1,6
095002,Tuesday,11,0,0,0,11
095003,Tuesday,9,0,0,0,9
095003,Tuesday,8,0,0,1,9
095003,Tuesday,8,0,0,0,8
095003,Tuesday,9,0,0,0,9
095004,Tuesday,3,0,0,1,4
095004,Tuesday,5,0,0,1,6
095004,Tuesday,3,0,0,1,4
095004,Tuesday,5,0,0,1,6
095005,Tuesday,2,0,0,2,4
095006,Tuesday,3,0,0,2,5
095006,Tuesday,5,0,0,0,5
095006,Tuesday,11,0,0,0,11
095007,Tuesday,7,0,0,2,9
095007,Tuesday,12,0,0,0,12
095007,Tuesday,12,0,0,0,12
095007,Tuesday,10,0,0,0,10
095007,Tuesday,10,0,0,0,10
095008,Tuesday,10,0,0,0,10
095008,Tuesday,10,0,0,0,10
095008,Tuesday,11,0,0,0,11
095008,Tuesday,8,0,0,2,10
095009,Tuesday,8,0,0,0,8
095009,Tuesday,2,0,0,1,3
095009,Tuesday,10,0,0,0,10
095009,Tuesday,6,0,0,1,7
095010,Tuesday,7,0,0,3,10
095010,Tuesday,13,0,0,0,13
095010,Tuesday,7,0,0,0,7
095010,Tuesday,7,0,0,0,7
095010,Tuesday,10,0,0,1,11
095011,Tuesday,12,0,0,0,12
095011,Tuesday,3,0,0,0,3
095011,Tuesday,12,0,0,0,12
095011,Tuesday,3,0,0,2,5
095012,Tuesday,12,0,0,0,12
095012,Tuesday,9,0,0,0,9
095012,Tuesday,7,0,0,1,8
095012,Tuesday,8,0,0,0,8
095012,Tuesday,7,0,0,0,7
095013,Tuesday,8,0,0,0,8
095013,Tuesday,9,0,0,0,9
095013,Tuesday,2,0,0,2,4
095013,Tuesday,8,0,0,0,8
095014,Tuesday,7,0,0,1,8
095014,Tuesday,10,0,0,0,10
095014,Tuesday,8,0,0,2,10
095014,Tuesday,8,0,0,0,8
095014,Tuesday,10,0,0,0,10
095015,Tuesday,10,0,0,1,11
095015,Tuesday,9,0,0,0,9
095015,Tuesday,8,0,0,1,9
095015,Tuesday,11,0,0,0,11
095015,Tuesday,11,0,0,0,11
095016,Tuesday,9,0,0,1,10
095016,Tuesday,8,0,0,1,9
095016,Tuesday,10,0,0,0,10
095016,Tuesday,12,0,0,0,12
095017,Tuesday,10,0,0,0,10
095017,Tuesday,8,0,0,0,8
095017,Tuesday,4,0,0,2,6
095017,Tuesday,5,0,0,1,6
095017,Tuesday,8,0,0,0,8
095018,Tuesday,9,0,0,1,10
095018,Tuesday,4,0,0,0,4
095018,Tuesday,11,0,0,0,11
095018,Tuesday,4,0,0,2,6
095018,Tuesday,3,0,0,2,5
095019,Tuesday,7,0,0,0,7
095019,Tuesday,10,0,0,0,10
095019,Tuesday,9,0,0,0,9
095019,Tuesday,10,0,0,0,10
095019,Tuesday,10,0,0,0,10
095020,Tuesday,2,0,0,0,2
095020,Tuesday,9,0,0,0,9
095020,Tuesday,8,0,0,1,9
095020,Tuesday,3,0,0,2,5
095020,Tuesday,6,0,0,1,7
095021,Tuesday,5,0,0,2,7
095021,Tuesday,7,0,0,0,7
095021,Tuesday,9,0,0,0,9
095021,Tuesday,11,0,0,0,11
095021,Tuesday,10,0,0,0,10
095022,Tuesday,8,0,0,0,8
095022,Tuesday,7,0,0,1,8
095022,Tuesday,9,0,0,2,11
095022,Tuesday,6,0,0,1,7
095022,Tuesday,7,0,0,1,8
095023,Tuesday,7,0,0,2,9
095023,Tuesday,4,0,0,0,4
095023,Tuesday,11,0,0,0,11
095023,Tuesday,11,0,0,0,11
095023,Tuesday,12,0,0,0,12
095024,Tuesday,3,0,0,0,3
095024,Tuesday,7,0,0,1,8
095024,Tuesday,9,0,0,1,10
095024,Tuesday,6,0,0,1,7
095024,Tuesday,8,0,0,0,8
095025,Tuesday,12,0,0,0,12
095025,Tuesday,10,0,0,0,10
095025,Tuesday,3,0,0,1,4
095025,Tuesday,12,0,0,0,12
095025,Tuesday,11,0,0,0,11
095026,Tuesday,5,0,0,0,5
095026,Tuesday,11,0,0,0,11
095026,Tuesday,12,0,0,0,12
095026,Tuesday,8,0,0,0,8
095026,Tuesday,8,0,0,0,8
095027,Tuesday,5,0,0,0,5
095027,Tuesday,10,0,0,0,10
095027,Tuesday,10,0,1,0,11
095027,Tuesday,9,0,0,0,9
095027,Tuesday,4,0,0,1,5
095028,Tuesday,9,0,0,1,10
095028,Tuesday,11,0,0,0,11
095028,Tuesday,6,0,1,1,8
095028,Tuesday,8,0,0,0,8
095029,Tuesday,11,0,0,0,11
095029,Tuesday,11,0,0,0,11
095029,Tuesday,7,0,0,0,7
095029,Tuesday,7,0,0,1,8
095029,Tuesday,11,0,0,0,11
095030,Tuesday,6,0,0,1,7
095030,Tuesday,9,0,0,0,9
095030,Tuesday,4,0,0,2,6
095030,Tuesday,6,0,0,1,7
095030,Tuesday,9,0,0,0,9
095031,Tuesday,11,0,0,0,11
095031,Tuesday,6,0,0,1,7
095031,Tuesday,8,0,0,0,8
095031,Tuesday,9,0,0,0,9
095031,Tuesday,11,0,0,0,11
095032,Tuesday,8,0,0,0,8
095032,Tuesday,3,0,0,0,3
095032,Tuesday,3,0,0,2,5
095032,Tuesday,9,0,0,0,9
095033,Tuesday,11,0,0,0,11
095033,Tuesday,9,0,0,0,9
095033,Tuesday,2,0,0,1,3
095033,Tuesday,8,0,0,1,9
095033,Tuesday,2,0,0,2,4
095034,Tuesday,12,0,0,0,12
095034,Tuesday,8,0,0,1,9
095034,Tuesday,9,0,0,1,10
095034,Tuesday,1,0,0,0,1
095035,Tuesday,2,0,0,1,3
095035,Tuesday,11,0,0,1,12
095035,Tuesday,9,0,0,0,9
095035,Tuesday,7,0,0,2,9
095036,Tuesday,13,0,0,0,13
095036,Tuesday,8,0,0,1,9
095036,Tuesday,10,0,0,0,10
095036,Tuesday,4,0,0,2,6
095037,Tuesday,9,0,0,0,9
095037,Tuesday,7,0,0,2,9
095037,Tuesday,5,0,0,1,6
095037,Tuesday,12,0,0,0,12
095038,Tuesday,10,0,0,0,10
095038,Tuesday,9,0,0,1,10
095039,Tuesday,11,0,0,0,11
095039,Tuesday,6,0,0,1,7
095040,Tuesday,11,0,0,0,11
095040,Tuesday,10,0,0,0,10
095040,Tuesday,12,0,0,0,12
095040,Tuesday,6,0,0,1,7
095040,Tuesday,3,0,0,2,5
095041,Tuesday,13,0,0,0,13
095041,Tuesday,3,0,0,1,4
095041,Tuesday,9,0,0,0,9
095041,Tuesday,11,0,0,0,11
095042,Tuesday,4,0,0,0,4
095042,Tuesday,10,0,0,0,10
095042,Tuesday,10,0,0,0,10
095042,Tuesday,8,0,0,0,8
095043,Tuesday,12,0,0,0,12
095043,Tuesday,9,0,0,0,9
095043,Tuesday,3,0,0,2,5
095043,Tuesday,9,0,0,0,9
095043,Tuesday,2,0,0,0,2
095044,Tuesday,2,0,0,2,4
095044,Tuesday,10,0,0,0,10
095044,Tuesday,5,0,0,2,7
095044,Tuesday,6,0,0,1,7
095045,Tuesday,5,0,0,1,6
095045,Tuesday,10,0,0,0,10
095045,Tuesday,10,0,0,0,10
095045,Tuesday,8,0,0,0,8
095045,Tuesday,3,0,0,2,5
095046,Tuesday,2,0,0,0,2
102924,Tuesday,10,0,0,0,10
102956,Tuesday,10,0,0,0,10
102956,Tuesday,11,0,0,0,11
102956,Tuesday,11,0,0,0,11
102957,Tuesday,8,0,0,1,9
102957,Tuesday,5,0,0,2,7
102957,Tuesday,8,0,0,0,8
102957,Tuesday,8,0,0,0,8
102958,Tuesday,11,0,0,0,11
102958,Tuesday,11,0,0,0,11
102958,Tuesday,6,0,0,1,7
102958,Tuesday,5,0,0,1,6
102959,Tuesday,9,0,0,0,9
102959,Tuesday,6,0,0,2,8
102959,Tuesday,12,0,0,0,12
