Time,Day of the week,CarCount,BikeCount,BusCount,TruckCount,Total
103438,Tuesday,10,0,0,0,10
103504,Tuesday,10,0,0,0,10
103515,Tuesday,10,0,0,0,10
103537,Tuesday,10,0,0,0,10
103537,Tuesday,11,0,0,0,11
103537,Tuesday,11,0,0,0,11
103537,Tuesday,8,0,0,1,9
103538,Tuesday,5,0,0,2,7
103538,Tuesday,8,0,0,0,8
103538,Tuesday,8,0,0,0,8
103539,Tuesday,11,0,0,0,11
103539,Tuesday,11,0,0,0,11
103539,Tuesday,6,0,0,1,7
103539,Tuesday,5,0,0,1,6
103540,Tuesday,9,0,0,0,9
103540,Tuesday,6,0,0,2,8
103540,Tuesday,12,0,0,0,12
103541,Tuesday,11,0,0,0,11
103541,Tuesday,2,0,0,2,4
103541,Tuesday,3,0,0,2,5
103541,Tuesday,3,0,0,2,5
103542,Tuesday,11,0,0,0,11
103542,Tuesday,8,0,0,0,8
103542,Tuesday,7,0,0,0,7
103543,Tuesday,10,0,0,0,10
103543,Tuesday,9,0,0,1,10
103543,Tuesday,6,0,0,1,7
103543,Tuesday,8,0,0,1,9
103544,Tuesday,10,0,0,0,10
103544,Tuesday,2,0,0,0,2
103544,Tuesday,7,0,0,0,7
103545,Tuesday,11,0,0,0,11
103545,Tuesday,11,0,0,0,11
103545,Tuesday,7,0,0,0,7
103545,Tuesday,12,0,0,0,12
103546,Tuesday,12,0,0,0,12
103546,Tuesday,6,0,0,1,7
103546,Tuesday,11,0,0,0,11
103547,Tuesday,6,0,0,1,7
103547,Tuesday,8,0,0,0,8
103547,Tuesday,8,0,0,0,8
103547,Tuesday,9,0,0,1,10
103548,Tuesday,12,0,0,0,12
103548,Tuesday,2,0,0,1,3
103548,Tuesday,11,0,0,0,11
103549,Tuesday,4,0,0,1,5
103549,Tuesday,8,0,0,1,9
103549,Tuesday,2,0,0,0,2
103549,Tuesday,8,0,0,0,8
103550,Tuesday,5,0,0,2,7
103550,Tuesday,13,0,0,0,13
103550,Tuesday,12,0,0,0,12
103551,Tuesday,9,0,0,0,9
103551,Tuesday,7,0,0,2,9
103551,Tuesday,5,0,0,2,7
103551,Tuesday,8,0,0,1,9
103552,Tuesday,8,0,0,1,9
103552,Tuesday,11,0,0,0,11
103552,Tuesday,9,0,0,0,9
103553,Tuesday,9,0,0,0,9
103553,Tuesday,5,0,0,1,6
103553,Tuesday,10,0,0,1,11
103553,Tuesday,5,0,0,1,6
103554,Tuesday,11,0,0,0,11
103554,Tuesday,2,0,0,1,3
103554,Tuesday,6,0,0,1,7
103555,Tuesday,5,0,0,1,6
103555,Tuesday,8,0,0,1,9
103557,Tuesday,9,0,0,0,9
103557,Tuesday,11,0,0,0,11
103557,Tuesday,2,0,0,1,3
103557,Tuesday,4,0,0,0,4
103558,Tuesday,9,0,0,0,9
103558,Tuesday,10,0,0,0,10
103558,Tuesday,3,0,0,2,5
103559,Tuesday,6,0,0,1,7
103559,Tuesday,11,0,0,0,11
103559,Tuesday,7,0,0,1,8
103559,Tuesday,11,0,0,0,11
103600,Tuesday,5,0,0,1,6
103600,Tuesday,5,0,0,2,7
103600,Tuesday,7,0,0,1,8
103601,Tuesday,12,0,0,0,12
103601,Tuesday,11,0,0,0,11
103601,Tuesday,2,0,0,0,2
103601,Tuesday,7,0,0,0,7
103602,Tuesday,11,0,0,0,11
103602,Tuesday,11,0,0,0,11
103602,Tuesday,12,0,0,0,12
103603,Tuesday,9,0,0,1,10
103603,Tuesday,6,0,0,1,7
103603,Tuesday,12,0,0,0,12
103603,Tuesday,6,0,0,1,7
103604,Tuesday,3,0,0,2,5
103604,Tuesday,4,0,0,0,4
103604,Tuesday,10,0,0,0,10
103605,Tuesday,12,0,0,0,12
103605,Tuesday,6,0,0,1,7
103605,Tuesday,7,0,0,1,8
103605,Tuesday,2,0,0,2,4
103606,Tuesday,11,0,0,0,11
103606,Tuesday,3,0,0,1,4
103606,Tuesday,6,0,0,1,7
103607,Tuesday,12,0,0,0,12
103607,Tuesday,9,0,0,0,9
103607,Tuesday,8,0,0,1,9
103607,Tuesday,11,0,0,0,11
103608,Tuesday,6,0,0,1,7
103608,Tuesday,8,0,0,0,8
103608,Tuesday,11,0,0,0,11
103609,Tuesday,4,0,0,1,5
103609,Tuesday,10,0,0,0,10
103609,Tuesday,9,0,0,0,9
103609,Tuesday,12,0,0,0,12
103610,Tuesday,6,0,0,1,7
103610,Tuesday,5,0,0,1,6
103610,Tuesday,11,0,0,0,11
103611,Tuesday,5,0,0,1,6
103611,Tuesday,6,0,0,1,7
103611,Tuesday,9,0,0,1,10
103611,Tuesday,3,0,0,1,4
103612,Tuesday,6,0,0,1,7
103612,Tuesday,10,0,0,1,11
103612,Tuesday,8,0,0,1,9
103613,Tuesday,4,0,0,2,6
103613,Tuesday,7,0,0,0,7
103613,Tuesday,8,0,0,0,8
103613,Tuesday,9,0,0,0,9
103614,Tuesday,3,0,0,0,3
103614,Tuesday,12,0,0,0,12
103614,Tuesday,10,0,0,0,10
103615,Tuesday,8,0,0,1,9
103615,Tuesday,6,0,0,2,8
103615,Tuesday,9,0,0,0,9
103615,Tuesday,10,0,0,0,10
103616,Tuesday,5,0,0,2,7
103616,Tuesday,8,0,0,1,9
103616,Tuesday,6,0,0,2,8
103617,Tuesday,11,0,0,0,11
103617,Tuesday,12,0,0,0,12
103617,Tuesday,6,0,0,1,7
103617,Tuesday,3,0,0,1,4
103618,Tuesday,12,0,0,0,12
103618,Tuesday,9,0,0,0,9
103618,Tuesday,8,0,0,0,8
103619,Tuesday,6,0,0,2,8
103619,Tuesday,4,0,0,0,4
103619,Tuesday,8,0,0,0,8
103619,Tuesday,10,0,0,0,10
103620,Tuesday,8,0,0,0,8
103620,Tuesday,10,0,0,0,10
103620,Tuesday,3,0,0,2,5
103621,Tuesday,11,0,0,0,11
103621,Tuesday,6,0,0,1,7
103621,Tuesday,9,0,0,0,9
103621,Tuesday,5,0,0,2,7
103622,Tuesday,2,0,0,2,4
103622,Tuesday,2,0,0,1,3
103622,Tuesday,11,0,0,0,11
103623,Tuesday,12,0,0,0,12
103623,Tuesday,10,0,0,0,10
103623,Tuesday,11,0,0,0,11
103623,Tuesday,7,0,0,0,7
103624,Tuesday,2,0,0,1,3
103624,Tuesday,8,0,0,1,9
103624,Tuesday,3,0,0,1,4
103625,Tuesday,8,0,0,0,8
103625,Tuesday,11,0,0,0,11
103625,Tuesday,7,0,0,0,7
103625,Tuesday,6,0,0,1,7
103626,Tuesday,11,0,0,0,11
103626,Tuesday,9,0,0,0,9
103626,Tuesday,10,0,0,0,10
103627,Tuesday,6,0,0,1,7
103627,Tuesday,11,0,0,0,11
103627,Tuesday,10,0,0,0,10
103627,Tuesday,2,0,0,0,2
103628,Tuesday,7,0,0,1,8
103628,Tuesday,11,0,0,0,11
103628,Tuesday,11,0,0,0,11
103629,Tuesday,2,0,0,0,2
103630,Tuesday,7,0,0,0,7
103631,Tuesday,11,0,0,0,11
103631,Tuesday,7,0,0,0,7
103631,Tuesday,8,0,0,0,8
103631,Tuesday,11,0,0,0,11
103632,Tuesday,10,0,0,0,10
103632,Tuesday,8,0,0,0,8
103632,Tuesday,7,0,0,0,7
103633,Tuesday,10,0,0,0,10
103633,Tuesday,10,0,0,0,10
103633,Tuesday,5,0,0,1,6
103633,Tuesday,9,0,0,0,9
103634,Tuesday,11,0,0,0,11
103634,Tuesday,7,0,0,0,7
103634,Tuesday,10,0,1,0,11
103635,Tuesday,8,0,0,0,8
103635,Tuesday,5,0,0,2,7
103635,Tuesday,11,0,0,0,11
103635,Tuesday,12,0,0,0,12
103636,Tuesday,7,0,0,1,8
103636,Tuesday,9,0,0,0,9
103636,Tuesday,10,0,0,0,10
103637,Tuesday,8,0,0,0,8
103637,Tuesday,8,0,0,0,8
103637,Tuesday,10,0,0,0,10
103637,Tuesday,11,0,0,0,11
103638,Tuesday,7,0,1,1,9
103638,Tuesday,8,0,0,0,8
103638,Tuesday,8,0,0,0,8
103639,Tuesday,3,0,0,2,5
103639,Tuesday,12,0,0,0,12
103639,Tuesday,10,0,0,0,10
103639,Tuesday,3,0,0,1,4
103640,Tuesday,8,0,0,0,8
103640,Tuesday,11,0,0,1,12
103640,Tuesday,6,0,0,1,7
103641,Tuesday,11,0,0,0,11
103641,Tuesday,9,0,0,0,9
103641,Tuesday,11,0,0,0,11
103641,Tuesday,7,0,0,1,8
103642,Tuesday,9,0,0,1,10
103642,Tuesday,5,0,0,2,7
103642,Tuesday,12,0,0,0,12
103643,Tuesday,9,0,0,0,9
103643,Tuesday,3,0,0,2,5
103643,Tuesday,9,0,0,0,9
103643,Tuesday,4,0,0,0,4
103644,Tuesday,12,0,0,0,12
103644,Tuesday,8,0,0,2,10
103644,Tuesday,3,0,0,0,3
103645,Tuesday,11,0,0,0,11
103708,Tuesday,10,0,0,0,10
103708,Tuesday,11,0,0,0,11
103708,Tuesday,11,0,0,0,11
103709,Tuesday,8,0,0,1,9
103709,Tuesday,5,0,0,2,7
103709,Tuesday,8,0,0,0,8
103710,Tuesday,8,0,0,0,8
103710,Tuesday,11,0,0,0,11
103710,Tuesday,11,0,0,0,11
103710,Tuesday,6,0,0,1,7
103711,Tuesday,5,0,0,1,6
103711,Tuesday,9,0,0,0,9
103711,Tuesday,6,0,0,2,8
103712,Tuesday,12,0,0,0,12
103712,Tuesday,11,0,0,0,11
103712,Tuesday,2,0,0,2,4
103712,Tuesday,3,0,0,2,5
103713,Tuesday,3,0,0,2,5
103713,Tuesday,11,0,0,0,11
103713,Tuesday,8,0,0,0,8
103714,Tuesday,7,0,0,0,7
103714,Tuesday,10,0,0,0,10
103714,Tuesday,9,0,0,1,10
103714,Tuesday,6,0,0,1,7
103715,Tuesday,8,0,0,1,9
103715,Tuesday,10,0,0,0,10
103715,Tuesday,2,0,0,0,2
103716,Tuesday,7,0,0,0,7
103716,Tuesday,11,0,0,0,11
103810,Tuesday,10,0,0,0,10
103811,Tuesday,11,0,0,0,11
103812,Tuesday,11,0,0,0,11
103812,Tuesday,8,0,0,1,9
103812,Tuesday,5,0,0,2,7
103812,Tuesday,8,0,0,0,8
103813,Tuesday,8,0,0,0,8
103813,Tuesday,11,0,0,0,11
103813,Tuesday,11,0,0,0,11
103814,Tuesday,6,0,0,1,7
103814,Tuesday,5,0,0,1,6
103814,Tuesday,9,0,0,0,9
103814,Tuesday,6,0,0,2,8
103815,Tuesday,12,0,0,0,12
103815,Tuesday,11,0,0,0,11
103815,Tuesday,2,0,0,2,4
103816,Tuesday,3,0,0,2,5
103816,Tuesday,3,0,0,2,5
103816,Tuesday,11,0,0,0,11
103816,Tuesday,8,0,0,0,8
103817,Tuesday,7,0,0,0,7
103817,Tuesday,10,0,0,0,10
103817,Tuesday,9,0,0,1,10
103818,Tuesday,6,0,0,1,7
103818,Tuesday,8,0,0,1,9
103818,Tuesday,10,0,0,0,10
103818,Tuesday,2,0,0,0,2
103819,Tuesday,7,0,0,0,7
103819,Tuesday,11,0,0,0,11
103819,Tuesday,11,0,0,0,11
103820,Tuesday,7,0,0,0,7
103820,Tuesday,12,0,0,0,12
103820,Tuesday,12,0,0,0,12
103820,Tuesday,6,0,0,1,7
103821,Tuesday,11,0,0,0,11
103821,Tuesday,6,0,0,1,7
103821,Tuesday,8,0,0,0,8
103822,Tuesday,8,0,0,0,8
103822,Tuesday,9,0,0,1,10
103822,Tuesday,12,0,0,0,12
103822,Tuesday,2,0,0,1,3
103823,Tuesday,11,0,0,0,11
103823,Tuesday,4,0,0,1,5
103823,Tuesday,8,0,0,1,9
103824,Tuesday,2,0,0,0,2
104000,Tuesday,10,0,0,0,10
104000,Tuesday,11,0,0,0,11
104001,Tuesday,11,0,0,0,11
104001,Tuesday,8,0,0,1,9
104001,Tuesday,5,0,0,2,7
104002,Tuesday,8,0,0,0,8
104002,Tuesday,8,0,0,0,8
104002,Tuesday,11,0,0,0,11
104002,Tuesday,11,0,0,0,11
104003,Tuesday,6,0,0,1,7
104003,Tuesday,5,0,0,1,6
104003,Tuesday,9,0,0,0,9
104004,Tuesday,6,0,0,2,8
104004,Tuesday,12,0,0,0,12
104004,Tuesday,11,0,0,0,11
104005,Tuesday,2,0,0,2,4
104005,Tuesday,3,0,0,2,5
104005,Tuesday,3,0,0,2,5
104005,Tuesday,11,0,0,0,11
104006,Tuesday,8,0,0,0,8
104006,Tuesday,7,0,0,0,7
104006,Tuesday,10,0,0,0,10
104007,Tuesday,9,0,0,1,10
104007,Tuesday,6,0,0,1,7
104007,Tuesday,8,0,0,1,9
104008,Tuesday,10,0,0,0,10
104008,Tuesday,2,0,0,0,2
104008,Tuesday,7,0,0,0,7
104231,Tuesday,10,0,0,0,10
104232,Tuesday,11,0,0,0,11
104232,Tuesday,11,0,0,0,11
104232,Tuesday,8,0,0,1,9
104233,Tuesday,5,0,0,2,7
104233,Tuesday,8,0,0,0,8
104233,Tuesday,8,0,0,0,8
104234,Tuesday,11,0,0,0,11
104234,Tuesday,11,0,0,0,11
104234,Tuesday,6,0,0,1,7
104235,Tuesday,5,0,0,1,6
104235,Tuesday,9,0,0,0,9
104235,Tuesday,6,0,0,2,8
104236,Tuesday,12,0,0,0,12
104236,Tuesday,11,0,0,0,11
104236,Tuesday,2,0,0,2,4
104236,Tuesday,3,0,0,2,5
104237,Tuesday,3,0,0,2,5
104237,Tuesday,11,0,0,0,11
104237,Tuesday,8,0,0,0,8
104238,Tuesday,7,0,0,0,7
104238,Tuesday,10,0,0,0,10
104238,Tuesday,9,0,0,1,10
104239,Tuesday,6,0,0,1,7
104239,Tuesday,8,0,0,1,9
104239,Tuesday,10,0,0,0,10
104241,Tuesday,2,0,0,0,2
104241,Tuesday,7,0,0,0,7
104242,Tuesday,11,0,0,0,11
104242,Tuesday,11,0,0,0,11
104242,Tuesday,7,0,0,0,7
104243,Tuesday,12,0,0,0,12
104243,Tuesday,12,0,0,0,12
104243,Tuesday,6,0,0,1,7
104244,Tuesday,11,0,0,0,11
104244,Tuesday,6,0,0,1,7
104244,Tuesday,8,0,0,0,8
104244,Tuesday,8,0,0,0,8
104245,Tuesday,9,0,0,1,10
104245,Tuesday,12,0,0,0,12
104245,Tuesday,2,0,0,1,3
104246,Tuesday,11,0,0,0,11
104246,Tuesday,4,0,0,1,5
104246,Tuesday,8,0,0,1,9
104247,Tuesday,2,0,0,0,2
104247,Tuesday,8,0,0,0,8
104247,Tuesday,5,0,0,2,7
104248,Tuesday,13,0,0,0,13
104248,Tuesday,12,0,0,0,12
104248,Tuesday,9,0,0,0,9
104248,Tuesday,7,0,0,2,9
104249,Tuesday,5,0,0,2,7
104249,Tuesday,8,0,0,1,9
104249,Tuesday,8,0,0,1,9
104250,Tuesday,11,0,0,0,11
104250,Tuesday,9,0,0,0,9
104250,Tuesday,9,0,0,0,9
104251,Tuesday,5,0,0,1,6
104251,Tuesday,10,0,0,1,11
104251,Tuesday,5,0,0,1,6
104251,Tuesday,11,0,0,0,11
104252,Tuesday,2,0,0,1,3
104252,Tuesday,6,0,0,1,7
104252,Tuesday,5,0,0,1,6
104253,Tuesday,8,0,0,1,9
104253,Tuesday,9,0,0,0,9
104253,Tuesday,11,0,0,0,11
104254,Tuesday,2,0,0,1,3
104254,Tuesday,4,0,0,0,4
104254,Tuesday,9,0,0,0,9
104255,Tuesday,10,0,0,0,10
104255,Tuesday,3,0,0,2,5
104255,Tuesday,6,0,0,1,7
104255,Tuesday,11,0,0,0,11
104256,Tuesday,7,0,0,1,8
104256,Tuesday,11,0,0,0,11
104256,Tuesday,5,0,0,1,6
104257,Tuesday,5,0,0,2,7
104257,Tuesday,7,0,0,1,8
104257,Tuesday,12,0,0,0,12
104258,Tuesday,11,0,0,0,11
104258,Tuesday,2,0,0,0,2
104258,Tuesday,7,0,0,0,7
104258,Tuesday,11,0,0,0,11
104259,Tuesday,11,0,0,0,11
104259,Tuesday,12,0,0,0,12
104259,Tuesday,9,0,0,1,10
104300,Tuesday,6,0,0,1,7
104300,Tuesday,12,0,0,0,12
104300,Tuesday,6,0,0,1,7
104301,Tuesday,3,0,0,2,5
104301,Tuesday,4,0,0,0,4
104301,Tuesday,10,0,0,0,10
104302,Tuesday,12,0,0,0,12
104302,Tuesday,6,0,0,1,7
104302,Tuesday,7,0,0,1,8
104302,Tuesday,2,0,0,2,4
104303,Tuesday,11,0,0,0,11
104303,Tuesday,3,0,0,1,4
104303,Tuesday,6,0,0,1,7
104304,Tuesday,12,0,0,0,12
104304,Tuesday,9,0,0,0,9
104304,Tuesday,8,0,0,1,9
104305,Tuesday,11,0,0,0,11
104305,Tuesday,6,0,0,1,7
104305,Tuesday,8,0,0,0,8
104305,Tuesday,11,0,0,0,11
104306,Tuesday,4,0,0,1,5
104306,Tuesday,10,0,0,0,10
104306,Tuesday,9,0,0,0,9
104307,Tuesday,12,0,0,0,12
104307,Tuesday,6,0,0,1,7
104307,Tuesday,5,0,0,1,6
104308,Tuesday,11,0,0,0,11
104308,Tuesday,5,0,0,1,6
104308,Tuesday,6,0,0,1,7
104308,Tuesday,9,0,0,1,10
104309,Tuesday,3,0,0,1,4
104309,Tuesday,6,0,0,1,7
104309,Tuesday,10,0,0,1,11
104310,Tuesday,8,0,0,1,9
104310,Tuesday,4,0,0,2,6
104310,Tuesday,7,0,0,0,7
104311,Tuesday,8,0,0,0,8
104311,Tuesday,9,0,0,0,9
104311,Tuesday,3,0,0,0,3
104312,Tuesday,12,0,0,0,12
104312,Tuesday,10,0,0,0,10
104312,Tuesday,8,0,0,1,9
104312,Tuesday,6,0,0,2,8
104313,Tuesday,9,0,0,0,9
104313,Tuesday,10,0,0,0,10
104315,Tuesday,5,0,0,2,7
104315,Tuesday,8,0,0,1,9
104316,Tuesday,6,0,0,2,8
104316,Tuesday,11,0,0,0,11
104316,Tuesday,12,0,0,0,12
104316,Tuesday,6,0,0,1,7
104317,Tuesday,3,0,0,1,4
104317,Tuesday,12,0,0,0,12
104317,Tuesday,9,0,0,0,9
104318,Tuesday,8,0,0,0,8
104318,Tuesday,6,0,0,2,8
104318,Tuesday,4,0,0,0,4
104319,Tuesday,8,0,0,0,8
104319,Tuesday,10,0,0,0,10
104319,Tuesday,8,0,0,0,8
104320,Tuesday,10,0,0,0,10
104320,Tuesday,3,0,0,2,5
104320,Tuesday,11,0,0,0,11
104320,Tuesday,6,0,0,1,7
104321,Tuesday,9,0,0,0,9
104321,Tuesday,5,0,0,2,7
104321,Tuesday,2,0,0,2,4
104322,Tuesday,2,0,0,1,3
104322,Tuesday,11,0,0,0,11
104322,Tuesday,12,0,0,0,12
104323,Tuesday,10,0,0,0,10
104323,Tuesday,11,0,0,0,11
104323,Tuesday,7,0,0,0,7
104323,Tuesday,2,0,0,1,3
104324,Tuesday,8,0,0,1,9
104324,Tuesday,3,0,0,1,4
104324,Tuesday,8,0,0,0,8
104325,Tuesday,11,0,0,0,11
104325,Tuesday,7,0,0,0,7
104325,Tuesday,6,0,0,1,7
104326,Tuesday,11,0,0,0,11
104326,Tuesday,9,0,0,0,9
104326,Tuesday,10,0,0,0,10
104327,Tuesday,6,0,0,1,7
104327,Tuesday,11,0,0,0,11
104327,Tuesday,10,0,0,0,10
104327,Tuesday,2,0,0,0,2
104328,Tuesday,7,0,0,1,8
104328,Tuesday,11,0,0,0,11
104328,Tuesday,11,0,0,0,11
104329,Tuesday,2,0,0,0,2
104329,Tuesday,7,0,0,0,7
104329,Tuesday,11,0,0,0,11
104330,Tuesday,7,0,0,0,7
104330,Tuesday,8,0,0,0,8
104330,Tuesday,11,0,0,0,11
104331,Tuesday,10,0,0,0,10
104331,Tuesday,8,0,0,0,8
104331,Tuesday,7,0,0,0,7
104331,Tuesday,10,0,0,0,10
104332,Tuesday,10,0,0,0,10
104332,Tuesday,5,0,0,1,6
104332,Tuesday,9,0,0,0,9
104333,Tuesday,11,0,0,0,11
104333,Tuesday,7,0,0,0,7
104333,Tuesday,10,0,1,0,11
104334,Tuesday,8,0,0,0,8
104334,Tuesday,5,0,0,2,7
104334,Tuesday,11,0,0,0,11
104335,Tuesday,12,0,0,0,12
104335,Tuesday,7,0,0,1,8
104335,Tuesday,9,0,0,0,9
104336,Tuesday,10,0,0,0,10
104336,Tuesday,8,0,0,0,8
104336,Tuesday,8,0,0,0,8
104336,Tuesday,10,0,0,0,10
104337,Tuesday,11,0,0,0,11
104337,Tuesday,7,0,1,1,9
104337,Tuesday,8,0,0,0,8
104338,Tuesday,8,0,0,0,8
104338,Tuesday,3,0,0,2,5
104338,Tuesday,12,0,0,0,12
104339,Tuesday,10,0,0,0,10
104339,Tuesday,3,0,0,1,4
104339,Tuesday,8,0,0,0,8
104340,Tuesday,11,0,0,1,12
104340,Tuesday,6,0,0,1,7
104340,Tuesday,11,0,0,0,11
104340,Tuesday,9,0,0,0,9
104341,Tuesday,11,0,0,0,11
104341,Tuesday,7,0,0,1,8
104341,Tuesday,9,0,0,1,10
104342,Tuesday,5,0,0,2,7
104342,Tuesday,12,0,0,0,12
104342,Tuesday,9,0,0,0,9
104343,Tuesday,3,0,0,2,5
104343,Tuesday,9,0,0,0,9
104343,Tuesday,4,0,0,0,4
104344,Tuesday,12,0,0,0,12
104344,Tuesday,8,0,0,2,10
104344,Tuesday,3,0,0,0,3
104344,Tuesday,11,0,0,0,11
104345,Tuesday,9,0,0,0,9
104345,Tuesday,9,0,0,0,9
104345,Tuesday,9,0,1,0,10
104346,Tuesday,4,0,0,0,4
104346,Tuesday,4,0,0,2,6
104346,Tuesday,8,0,0,0,8
104347,Tuesday,9,0,0,1,10
104347,Tuesday,8,0,0,0,8
104349,Tuesday,6,0,0,2,8
104349,Tuesday,3,0,0,1,4
104349,Tuesday,8,0,0,1,9
104350,Tuesday,9,0,0,0,9
104350,Tuesday,12,0,0,0,12
104350,Tuesday,6,0,0,1,7
104351,Tuesday,3,0,0,2,5
104351,Tuesday,10,0,0,0,10
104351,Tuesday,13,0,0,0,13
104352,Tuesday,2,0,0,0,2
104352,Tuesday,4,0,0,2,6
104352,Tuesday,5,0,0,1,6
104352,Tuesday,12,0,0,0,12
104353,Tuesday,3,0,0,1,4
104353,Tuesday,12,0,0,0,12
104353,Tuesday,5,0,0,2,7
104354,Tuesday,8,0,0,1,9
104354,Tuesday,7,0,0,1,8
104354,Tuesday,6,0,0,1,7
104355,Tuesday,5,0,0,1,6
104355,Tuesday,9,0,0,0,9
104355,Tuesday,10,0,0,0,10
104356,Tuesday,8,0,0,0,8
104356,Tuesday,8,0,0,1,9
104356,Tuesday,3,0,0,2,5
104356,Tuesday,12,0,0,0,12
104357,Tuesday,2,0,0,2,4
104357,Tuesday,12,0,0,0,12
104357,Tuesday,10,0,1,0,11
104358,Tuesday,5,0,0,1,6
104358,Tuesday,4,0,0,2,6
104358,Tuesday,12,0,0,0,12
104359,Tuesday,6,0,0,1,7
104359,Tuesday,11,0,0,0,11
104359,Tuesday,10,0,0,0,10
104400,Tuesday,5,0,0,2,7
104400,Tuesday,9,0,0,0,9
104400,Tuesday,8,0,0,0,8
104400,Tuesday,3,0,0,1,4
104401,Tuesday,10,0,0,0,10
104401,Tuesday,8,0,0,3,11
104401,Tuesday,11,0,0,1,12
104402,Tuesday,8,0,0,0,8
104402,Tuesday,9,0,0,0,9
104402,Tuesday,8,0,0,2,10
104403,Tuesday,5,0,0,1,6
104403,Tuesday,6,0,0,0,6
104403,Tuesday,9,0,0,0,9
104404,Tuesday,10,0,0,0,10
104404,Tuesday,3,0,0,2,5
104404,Tuesday,12,0,0,0,12
104404,Tuesday,4,0,0,0,4
104405,Tuesday,10,0,0,0,10
104405,Tuesday,10,0,0,0,10
104405,Tuesday,11,0,0,0,11
104406,Tuesday,11,0,0,0,11
104406,Tuesday,3,0,0,2,5
104406,Tuesday,11,0,0,0,11
104407,Tuesday,9,0,0,0,9
104407,Tuesday,5,0,0,0,5
104407,Tuesday,10,0,0,0,10
104408,Tuesday,5,0,0,1,6
104408,Tuesday,3,0,0,1,4
104408,Tuesday,12,0,0,0,12
104408,Tuesday,3,0,0,0,3
104409,Tuesday,11,0,0,0,11
104409,Tuesday,4,0,0,1,5
104409,Tuesday,10,0,0,0,10
104410,Tuesday,10,0,0,0,10
104410,Tuesday,8,0,0,0,8
104410,Tuesday,9,0,0,0,9
104411,Tuesday,8,0,0,0,8
104411,Tuesday,10,0,0,0,10
104411,Tuesday,10,0,0,0,10
104412,Tuesday,6,0,0,1,7
104412,Tuesday,3,0,0,0,3
104412,Tuesday,4,0,0,0,4
104413,Tuesday,11,0,0,0,11
104413,Tuesday,6,0,0,1,7
104413,Tuesday,7,0,0,0,7
104413,Tuesday,8,0,0,0,8
104414,Tuesday,11,0,0,0,11
104414,Tuesday,11,0,0,0,11
104414,Tuesday,5,0,0,1,6
104415,Tuesday,7,0,0,1,8
104415,Tuesday,5,0,0,1,6
104415,Tuesday,4,0,0,1,5
104416,Tuesday,8,0,0,1,9
104416,Tuesday,6,0,0,0,6
104416,Tuesday,10,0,0,0,10
104417,Tuesday,10,0,0,0,10
104417,Tuesday,12,0,0,0,12
104417,Tuesday,11,0,0,0,11
104418,Tuesday,2,0,0,2,4
104418,Tuesday,8,0,0,0,8
104418,Tuesday,11,0,0,0,11
104418,Tuesday,6,0,0,1,7
104419,Tuesday,8,0,0,0,8
104419,Tuesday,12,0,0,0,12
104419,Tuesday,7,0,1,1,9
104420,Tuesday,8,0,0,0,8
104420,Tuesday,10,0,0,0,10
104420,Tuesday,9,0,1,1,11
104421,Tuesday,4,0,0,0,4
104422,Tuesday,7,0,0,1,8
104423,Tuesday,4,0,0,2,6
104423,Tuesday,11,0,0,0,11
104423,Tuesday,5,0,0,2,7
104424,Tuesday,1,0,0,1,2
104424,Tuesday,11,0,0,0,11
104424,Tuesday,4,0,0,1,5
104425,Tuesday,12,0,0,0,12
104425,Tuesday,8,0,0,0,8
104425,Tuesday,11,0,0,0,11
104426,Tuesday,10,0,0,0,10
104426,Tuesday,9,0,0,0,9
104426,Tuesday,9,0,0,0,9
104427,Tuesday,11,0,0,0,11
104427,Tuesday,11,0,0,0,11
104427,Tuesday,12,0,0,0,12
104427,Tuesday,9,0,0,0,9
104428,Tuesday,9,0,0,0,9
104428,Tuesday,9,0,0,0,9
104428,Tuesday,7,0,0,0,7
104429,Tuesday,6,0,0,2,8
104429,Tuesday,3,0,0,1,4
104429,Tuesday,9,0,0,1,10
104430,Tuesday,8,0,0,0,8
104430,Tuesday,9,0,0,0,9
104430,Tuesday,3,0,0,1,4
104431,Tuesday,3,0,0,2,5
104431,Tuesday,12,0,0,0,12
104431,Tuesday,2,0,0,0,2
104432,Tuesday,9,0,0,2,11
104432,Tuesday,2,0,0,1,3
104432,Tuesday,10,0,0,0,10
104433,Tuesday,8,0,0,0,8
104433,Tuesday,10,0,0,0,10
104433,Tuesday,9,0,1,1,11
104433,Tuesday,12,0,0,0,12
104434,Tuesday,6,0,0,1,7
104434,Tuesday,9,0,0,0,9
104434,Tuesday,11,0,0,0,11
104435,Tuesday,10,0,0,1,11
104435,Tuesday,10,0,0,0,10
104435,Tuesday,8,0,0,2,10
104436,Tuesday,12,0,0,0,12
104436,Tuesday,7,0,0,1,8
104436,Tuesday,4,0,0,0,4
104437,Tuesday,9,0,0,0,9
104437,Tuesday,11,0,0,0,11
104437,Tuesday,11,0,0,0,11
104438,Tuesday,9,0,0,0,9
104438,Tuesday,9,0,0,2,11
104438,Tuesday,3,0,0,2,5
104439,Tuesday,5,0,0,1,6
104439,Tuesday,11,0,0,0,11
104439,Tuesday,1,0,0,1,2
104439,Tuesday,3,0,0,1,4
104440,Tuesday,11,0,0,0,11
104440,Tuesday,12,0,0,0,12
104440,Tuesday,9,0,0,1,10
104441,Tuesday,4,0,0,0,4
104441,Tuesday,5,0,0,1,6
104441,Tuesday,7,0,0,0,7
104442,Tuesday,10,0,0,0,10
104442,Tuesday,10,0,0,1,11
104442,Tuesday,11,0,0,0,11
104443,Tuesday,9,0,0,0,9
104443,Tuesday,10,0,0,0,10
104443,Tuesday,7,0,0,1,8
104444,Tuesday,9,0,0,1,10
104444,Tuesday,5,0,0,1,6
104444,Tuesday,11,0,0,0,11
104445,Tuesday,9,0,0,0,9
104445,Tuesday,2,0,0,1,3
104445,Tuesday,11,0,0,0,11
104445,Tuesday,3,0,0,1,4
104446,Tuesday,3,0,0,1,4
104446,Tuesday,11,0,0,0,11
104446,Tuesday,2,0,0,2,4
104447,Tuesday,2,0,0,1,3
104447,Tuesday,10,0,0,0,10
104447,Tuesday,2,0,0,2,4
104448,Tuesday,8,0,0,2,10
104448,Tuesday,7,0,0,1,8
104448,Tuesday,3,0,0,2,5
104449,Tuesday,10,0,0,0,10
104449,Tuesday,10,0,0,0,10
104449,Tuesday,10,0,0,0,10
104450,Tuesday,12,0,0,0,12
104450,Tuesday,11,0,0,0,11
104450,Tuesday,6,0,0,1,7
104451,Tuesday,4,0,0,1,5
104451,Tuesday,13,0,0,0,13
104451,Tuesday,8,0,0,1,9
104451,Tuesday,8,0,0,0,8
104452,Tuesday,9,0,0,0,9
104452,Tuesday,8,0,0,3,11
104452,Tuesday,6,0,0,1,7
104453,Tuesday,6,0,0,0,6
104453,Tuesday,11,0,0,0,11
104453,Tuesday,3,0,0,1,4
104454,Tuesday,3,0,0,0,3
104454,Tuesday,9,0,0,0,9
104454,Tuesday,10,0,0,0,10
104456,Tuesday,5,0,0,1,6
104456,Tuesday,6,0,0,1,7
104457,Tuesday,8,0,0,1,9
104457,Tuesday,4,0,0,0,4
104457,Tuesday,4,0,0,2,6
104458,Tuesday,8,0,0,0,8
104458,Tuesday,10,0,0,0,10
104458,Tuesday,12,0,0,0,12
104459,Tuesday,11,0,0,0,11
104459,Tuesday,7,0,0,2,9
104459,Tuesday,7,0,0,2,9
104500,Tuesday,10,0,0,0,10
104500,Tuesday,6,0,0,0,6
104500,Tuesday,12,0,0,0,12
104501,Tuesday,11,0,0,0,11
104501,Tuesday,10,0,0,0,10
104501,Tuesday,8,0,0,0,8
104502,Tuesday,9,0,0,0,9
104502,Tuesday,12,0,0,0,12
104502,Tuesday,7,0,0,0,7
104503,Tuesday,11,0,0,0,11
104503,Tuesday,12,0,0,0,12
104503,Tuesday,12,0,0,0,12
104503,Tuesday,11,0,0,0,11
104504,Tuesday,12,0,0,0,12
104504,Tuesday,10,0,1,0,11
104504,Tuesday,12,0,0,0,12
104505,Tuesday,2,0,0,2,4
104505,Tuesday,10,0,0,0,10
104505,Tuesday,5,0,0,1,6
104506,Tuesday,7,0,0,0,7
104506,Tuesday,3,0,0,1,4
104506,Tuesday,6,0,0,2,8
104507,Tuesday,5,0,0,1,6
104507,Tuesday,10,0,0,0,10
104507,Tuesday,9,0,0,1,10
104508,Tuesday,6,0,0,1,7
104508,Tuesday,13,0,0,0,13
104508,Tuesday,9,0,0,1,10
104508,Tuesday,10,0,0,0,10
104509,Tuesday,6,0,0,1,7
104509,Tuesday,12,0,0,0,12
104509,Tuesday,4,0,0,0,4
104510,Tuesday,9,0,0,1,10
104510,Tuesday,2,0,0,2,4
104510,Tuesday,12,0,0,0,12
104511,Tuesday,10,0,0,0,10
104511,Tuesday,11,0,0,0,11
104511,Tuesday,4,0,0,0,4
104512,Tuesday,5,0,0,2,7
104512,Tuesday,9,0,0,0,9
104512,Tuesday,11,0,0,0,11
104513,Tuesday,9,0,0,0,9
104513,Tuesday,8,0,0,0,8
104513,Tuesday,11,0,0,0,11
104514,Tuesday,10,0,0,0,10
104514,Tuesday,2,0,0,0,2
104514,Tuesday,12,0,0,0,12
104514,Tuesday,10,0,0,0,10
104515,Tuesday,5,0,0,0,5
104515,Tuesday,10,0,0,0,10
104515,Tuesday,5,0,0,0,5
104516,Tuesday,10,0,0,0,10
104516,Tuesday,2,0,0,1,3
104516,Tuesday,10,0,0,0,10
104517,Tuesday,11,0,0,0,11
104517,Tuesday,8,0,0,1,9
104517,Tuesday,10,0,0,0,10
104518,Tuesday,3,0,0,1,4
104518,Tuesday,7,0,0,0,7
104518,Tuesday,10,0,0,0,10
104519,Tuesday,2,0,0,0,2
104519,Tuesday,9,0,0,0,9
104519,Tuesday,8,0,0,0,8
104519,Tuesday,8,0,0,0,8
104520,Tuesday,9,0,0,0,9
104520,Tuesday,5,0,0,2,7
104520,Tuesday,11,0,0,0,11
104521,Tuesday,2,0,0,1,3
104521,Tuesday,9,0,0,0,9
104521,Tuesday,8,0,0,0,8
104522,Tuesday,8,0,0,0,8
104522,Tuesday,3,0,0,1,4
104522,Tuesday,2,0,0,2,4
104523,Tuesday,8,0,0,0,8
104523,Tuesday,4,0,0,0,4
104523,Tuesday,9,0,0,0,9
104523,Tuesday,2,0,0,0,2
104524,Tuesday,6,0,0,1,7
104524,Tuesday,10,0,0,1,11
104524,Tuesday,9,0,0,0,9
104525,Tuesday,9,0,0,0,9
104525,Tuesday,3,0,0,1,4
104525,Tuesday,10,0,0,0,10
104526,Tuesday,13,0,0,0,13
104526,Tuesday,8,0,0,3,11
104526,Tuesday,10,0,0,0,10
104527,Tuesday,8,0,0,0,8
104527,Tuesday,12,0,0,0,12
104527,Tuesday,3,0,0,1,4
104528,Tuesday,10,0,0,0,10
104528,Tuesday,8,0,0,0,8
104530,Tuesday,6,0,0,1,7
104530,Tuesday,11,0,0,0,11
104530,Tuesday,7,0,0,0,7
104531,Tuesday,11,0,0,0,11
104531,Tuesday,9,0,0,1,10
104531,Tuesday,3,0,0,1,4
104532,Tuesday,5,0,0,1,6
104532,Tuesday,6,0,0,1,7
104532,Tuesday,8,0,0,0,8
104532,Tuesday,2,0,0,0,2
104533,Tuesday,11,0,0,0,11
104533,Tuesday,2,0,0,1,3
104533,Tuesday,8,0,0,1,9
104534,Tuesday,12,0,0,0,12
104534,Tuesday,8,0,0,0,8
104534,Tuesday,9,0,1,0,10
104535,Tuesday,6,0,0,2,8
104535,Tuesday,10,0,0,0,10
104535,Tuesday,10,0,1,0,11
104536,Tuesday,9,0,0,0,9
104536,Tuesday,8,0,0,0,8
104536,Tuesday,7,0,0,1,8
104537,Tuesday,9,0,0,0,9
104537,Tuesday,7,0,0,2,9
104537,Tuesday,9,0,0,1,10
104537,Tuesday,9,0,0,1,10
104538,Tuesday,6,0,0,1,7
104538,Tuesday,9,0,0,0,9
104538,Tuesday,11,0,0,0,11
104539,Tuesday,7,0,0,0,7
104539,Tuesday,7,0,0,0,7
104539,Tuesday,3,0,0,1,4
104540,Tuesday,8,0,0,0,8
104540,Tuesday,12,0,0,0,12
104540,Tuesday,7,0,0,0,7
104541,Tuesday,10,0,0,0,10
104541,Tuesday,10,0,0,0,10
104541,Tuesday,4,0,0,0,4
104542,Tuesday,3,0,0,1,4
104542,Tuesday,2,0,0,2,4
104542,Tuesday,8,0,0,1,9
104543,Tuesday,7,0,0,0,7
104543,Tuesday,9,0,0,0,9
104543,Tuesday,8,0,1,0,9
104543,Tuesday,13,0,0,0,13
104544,Tuesday,12,0,0,0,12
104544,Tuesday,7,0,0,0,7
104544,Tuesday,10,0,0,0,10
104545,Tuesday,9,0,0,0,9
104545,Tuesday,8,0,0,0,8
104545,Tuesday,11,0,0,0,11
104546,Tuesday,11,0,0,0,11
104546,Tuesday,3,0,0,0,3
104546,Tuesday,8,0,0,0,8
104547,Tuesday,8,0,0,0,8
104547,Tuesday,8,0,0,1,9
104547,Tuesday,9,0,0,0,9
104548,Tuesday,11,0,0,0,11
104548,Tuesday,7,0,0,0,7
104548,Tuesday,12,0,0,0,12
104548,Tuesday,12,0,0,0,12
104549,Tuesday,9,0,0,1,10
104549,Tuesday,10,0,0,0,10
104549,Tuesday,8,0,0,0,8
104550,Tuesday,7,0,0,0,7
104550,Tuesday,3,0,0,1,4
104550,Tuesday,10,0,0,0,10
104551,Tuesday,11,0,0,0,11
104551,Tuesday,5,0,0,0,5
104551,Tuesday,9,0,0,0,9
104552,Tuesday,8,0,0,0,8
104552,Tuesday,8,0,0,0,8
104552,Tuesday,7,0,0,1,8
104552,Tuesday,7,0,0,0,7
104553,Tuesday,9,0,0,0,9
104553,Tuesday,8,0,0,0,8
104553,Tuesday,7,0,0,0,7
104554,Tuesday,9,0,0,0,9
104554,Tuesday,12,0,0,0,12
104554,Tuesday,9,0,0,0,9
104555,Tuesday,9,0,0,0,9
104555,Tuesday,7,0,0,0,7
104555,Tuesday,11,0,0,0,11
104556,Tuesday,11,0,0,0,11
104556,Tuesday,5,0,0,0,5
104556,Tuesday,11,0,0,0,11
104556,Tuesday,10,0,1,1,12
104557,Tuesday,3,0,0,2,5
104557,Tuesday,9,0,0,0,9
104557,Tuesday,4,0,0,0,4
104558,Tuesday,10,0,0,0,10
104558,Tuesday,10,0,0,0,10
104558,Tuesday,10,0,0,0,10
104559,Tuesday,12,0,0,0,12
104559,Tuesday,10,0,0,0,10
104559,Tuesday,6,0,0,1,7
104600,Tuesday,6,0,0,2,8
104600,Tuesday,3,0,0,2,5
104600,Tuesday,8,0,0,0,8
104601,Tuesday,6,0,0,0,6
104601,Tuesday,12,0,0,0,12
104601,Tuesday,11,0,0,0,11
104601,Tuesday,9,0,0,1,10
104602,Tuesday,7,0,0,2,9
104604,Tuesday,9,0,0,0,9
104604,Tuesday,3,0,0,2,5
104604,Tuesday,9,0,0,0,9
104605,Tuesday,7,0,0,2,9
104605,Tuesday,10,0,0,0,10
104605,Tuesday,3,0,0,0,3
104606,Tuesday,11,0,0,0,11
104606,Tuesday,11,0,0,0,11
104606,Tuesday,6,0,0,2,8
104607,Tuesday,2,0,0,2,4
104607,Tuesday,11,0,0,0,11
104607,Tuesday,2,0,0,0,2
104607,Tuesday,9,0,0,1,10
104608,Tuesday,10,0,0,0,10
104608,Tuesday,8,0,0,0,8
104608,Tuesday,4,0,0,1,5
104609,Tuesday,8,0,0,0,8
104609,Tuesday,11,0,0,0,11
104609,Tuesday,12,0,0,0,12
104610,Tuesday,11,0,0,0,11
104610,Tuesday,11,0,0,0,11
104610,Tuesday,3,0,0,1,4
104611,Tuesday,3,0,0,1,4
104611,Tuesday,3,0,0,1,4
104611,Tuesday,9,0,0,0,9
104612,Tuesday,11,0,0,0,11
104612,Tuesday,13,0,0,0,13
104612,Tuesday,9,0,0,0,9
104613,Tuesday,11,0,0,0,11
104613,Tuesday,12,0,0,0,12
104613,Tuesday,8,0,0,1,9
104613,Tuesday,9,0,0,0,9
104614,Tuesday,2,0,0,2,4
104614,Tuesday,8,0,0,0,8
104614,Tuesday,3,0,0,1,4
104615,Tuesday,2,0,0,1,3
104615,Tuesday,12,0,0,0,12
104615,Tuesday,10,0,1,1,12
104616,Tuesday,11,0,0,0,11
104616,Tuesday,11,0,0,0,11
104616,Tuesday,9,0,0,0,9
104616,Tuesday,12,0,0,0,12
104617,Tuesday,7,0,0,2,9
104617,Tuesday,2,0,0,1,3
104617,Tuesday,3,0,0,2,5
104618,Tuesday,11,0,0,0,11
104618,Tuesday,5,0,0,1,6
104618,Tuesday,7,0,0,0,7
104619,Tuesday,4,0,0,0,4
104619,Tuesday,6,0,0,1,7
104619,Tuesday,9,0,1,0,10
104619,Tuesday,10,0,0,0,10
104620,Tuesday,6,0,0,1,7
104620,Tuesday,4,0,0,0,4
104620,Tuesday,10,0,0,0,10
104621,Tuesday,9,0,0,1,10
104621,Tuesday,2,0,0,2,4
104621,Tuesday,8,0,0,0,8
104622,Tuesday,12,0,0,0,12
104622,Tuesday,10,0,0,0,10
104622,Tuesday,9,0,0,0,9
104623,Tuesday,10,0,0,0,10
104623,Tuesday,10,0,0,0,10
104623,Tuesday,10,0,0,0,10
104623,Tuesday,7,0,0,0,7
104624,Tuesday,12,0,0,0,12
104624,Tuesday,10,0,0,0,10
104624,Tuesday,2,0,0,2,4
104625,Tuesday,7,0,0,0,7
104625,Tuesday,4,0,0,1,5
104625,Tuesday,8,0,0,0,8
104626,Tuesday,11,0,0,0,11
104626,Tuesday,8,0,0,1,9
104626,Tuesday,8,0,0,1,9
104627,Tuesday,9,0,0,0,9
104627,Tuesday,11,0,0,0,11
104627,Tuesday,3,0,0,2,5
104628,Tuesday,10,0,0,0,10
104628,Tuesday,12,0,0,0,12
104628,Tuesday,6,0,0,0,6
104628,Tuesday,3,0,0,1,4
104629,Tuesday,8,0,0,0,8
104629,Tuesday,11,0,0,0,11
104629,Tuesday,4,0,0,0,4
104630,Tuesday,13,0,0,0,13
104630,Tuesday,8,0,0,0,8
104630,Tuesday,12,0,0,0,12
104631,Tuesday,8,0,0,0,8
104631,Tuesday,5,0,0,1,6
104631,Tuesday,7,0,0,2,9
104632,Tuesday,5,0,0,2,7
104632,Tuesday,9,0,0,0,9
104632,Tuesday,6,0,0,1,7
104633,Tuesday,10,0,0,0,10
104633,Tuesday,10,0,0,0,10
104633,Tuesday,13,0,0,0,13
104633,Tuesday,5,0,0,2,7
104634,Tuesday,11,0,0,0,11
104634,Tuesday,2,0,0,2,4
104634,Tuesday,12,0,0,0,12
104635,Tuesday,6,0,0,1,7
104635,Tuesday,9,0,0,0,9
104635,Tuesday,8,0,0,2,10
104636,Tuesday,12,0,0,0,12
104637,Tuesday,7,0,0,2,9
104638,Tuesday,11,0,0,0,11
104638,Tuesday,5,0,0,1,6
104638,Tuesday,9,0,0,0,9
104639,Tuesday,5,0,0,1,6
104639,Tuesday,10,0,0,0,10
104639,Tuesday,12,0,0,0,12
104640,Tuesday,3,0,0,0,3
104640,Tuesday,11,0,0,0,11
104640,Tuesday,11,0,0,0,11
104641,Tuesday,9,0,0,1,10
104641,Tuesday,8,0,0,1,9
104641,Tuesday,8,0,0,0,8
104642,Tuesday,9,0,0,0,9
104642,Tuesday,10,0,0,0,10
104642,Tuesday,10,0,0,0,10
104642,Tuesday,6,0,0,2,8
104643,Tuesday,11,0,0,0,11
104643,Tuesday,11,0,0,0,11
104643,Tuesday,11,0,0,0,11
104644,Tuesday,11,0,0,0,11
104644,Tuesday,2,0,0,2,4
104644,Tuesday,3,0,0,1,4
104645,Tuesday,7,0,0,2,9
104645,Tuesday,10,0,0,0,10
104645,Tuesday,11,0,0,1,12
104646,Tuesday,6,0,0,0,6
104646,Tuesday,2,0,0,2,4
104646,Tuesday,7,0,0,0,7
104647,Tuesday,8,0,0,1,9
104647,Tuesday,10,0,0,0,10
104647,Tuesday,6,0,0,1,7
104647,Tuesday,10,0,0,0,10
104648,Tuesday,11,0,0,0,11
104648,Tuesday,10,0,0,0,10
104648,Tuesday,10,0,0,0,10
104649,Tuesday,12,0,0,0,12
104649,Tuesday,12,0,0,0,12
104649,Tuesday,4,0,0,1,5
104650,Tuesday,10,0,0,0,10
104650,Tuesday,7,0,0,0,7
104650,Tuesday,10,0,0,0,10
104651,Tuesday,3,0,0,1,4
104651,Tuesday,3,0,0,1,4
104651,Tuesday,11,0,0,0,11
104651,Tuesday,11,0,0,0,11
104652,Tuesday,3,0,0,2,5
104652,Tuesday,2,0,0,0,2
104652,Tuesday,13,0,0,0,13
104653,Tuesday,10,0,0,0,10
104653,Tuesday,2,0,0,1,3
104653,Tuesday,7,0,0,0,7
104654,Tuesday,8,0,0,0,8
104654,Tuesday,8,0,0,0,8
104654,Tuesday,6,0,0,1,7
104655,Tuesday,9,0,0,0,9
104655,Tuesday,6,0,0,1,7
104655,Tuesday,8,0,0,0,8
104655,Tuesday,9,0,0,0,9
104656,Tuesday,6,0,0,1,7
104656,Tuesday,6,0,0,1,7
104656,Tuesday,9,0,0,0,9
104657,Tuesday,10,0,0,0,10
104657,Tuesday,6,0,0,1,7
104657,Tuesday,10,0,0,0,10
104658,Tuesday,8,0,0,0,8
104658,Tuesday,4,0,0,2,6
104658,Tuesday,9,0,0,0,9
104659,Tuesday,7,0,0,0,7
104659,Tuesday,10,0,0,0,10
104659,Tuesday,11,0,0,0,11
104659,Tuesday,10,0,0,0,10
104700,Tuesday,7,0,0,1,8
104700,Tuesday,11,0,0,0,11
104700,Tuesday,10,0,0,0,10
104701,Tuesday,11,0,0,0,11
104701,Tuesday,7,0,0,0,7
104701,Tuesday,8,0,0,0,8
104702,Tuesday,3,0,0,0,3
104702,Tuesday,4,0,0,2,6
104702,Tuesday,8,0,0,0,8
104703,Tuesday,8,0,0,0,8
104703,Tuesday,8,0,0,0,8
104703,Tuesday,8,0,0,0,8
104704,Tuesday,3,0,0,2,5
104704,Tuesday,9,0,0,0,9
104704,Tuesday,10,0,0,0,10
104704,Tuesday,4,0,0,0,4
104705,Tuesday,11,0,0,0,11
104705,Tuesday,8,0,0,1,9
104705,Tuesday,4,0,0,1,5
104706,Tuesday,6,0,0,1,7
104706,Tuesday,4,0,0,2,6
104706,Tuesday,3,0,0,1,4
104707,Tuesday,12,0,0,0,12
104707,Tuesday,9,0,0,0,9
104707,Tuesday,4,0,0,1,5
104708,Tuesday,9,0,0,0,9
104708,Tuesday,7,0,0,1,8
104708,Tuesday,9,0,0,1,10
104709,Tuesday,4,0,0,0,4
104709,Tuesday,3,0,0,2,5
104709,Tuesday,10,0,0,0,10
104711,Tuesday,2,0,0,0,2
104711,Tuesday,10,0,1,0,11
104712,Tuesday,3,0,0,2,5
104712,Tuesday,10,0,0,0,10
104712,Tuesday,11,0,0,0,11
104713,Tuesday,11,0,0,0,11
104713,Tuesday,2,0,0,0,2
104713,Tuesday,10,0,0,0,10
104713,Tuesday,11,0,0,0,11
104714,Tuesday,10,0,0,0,10
104714,Tuesday,8,0,0,1,9
104714,Tuesday,9,0,0,0,9
104715,Tuesday,3,0,0,1,4
104715,Tuesday,7,0,0,0,7
104715,Tuesday,11,0,0,0,11
104716,Tuesday,2,0,0,1,3
104716,Tuesday,8,0,0,0,8
104716,Tuesday,5,0,0,1,6
104717,Tuesday,7,0,0,1,8
104717,Tuesday,7,0,0,1,8
104717,Tuesday,5,0,0,2,7
104718,Tuesday,8,0,0,0,8
104718,Tuesday,2,0,0,0,2
104718,Tuesday,10,0,0,0,10
104719,Tuesday,7,0,0,0,7
104719,Tuesday,11,0,0,0,11
104719,Tuesday,10,0,0,0,10
104719,Tuesday,11,0,0,0,11
104720,Tuesday,11,0,0,0,11
104720,Tuesday,11,0,0,0,11
104720,Tuesday,10,0,0,0,10
104721,Tuesday,5,0,0,1,6
104721,Tuesday,8,0,0,0,8
104721,Tuesday,10,0,0,0,10
104722,Tuesday,11,0,0,0,11
104722,Tuesday,3,0,0,2,5
104722,Tuesday,10,0,0,0,10
104723,Tuesday,10,0,0,0,10
104723,Tuesday,7,0,0,0,7
104723,Tuesday,9,0,0,0,9
104724,Tuesday,9,0,0,0,9
104724,Tuesday,9,0,0,0,9
104724,Tuesday,9,0,0,0,9
104724,Tuesday,9,0,0,0,9
104725,Tuesday,5,0,0,1,6
104725,Tuesday,8,0,0,1,9
104725,Tuesday,8,0,0,0,8
104726,Tuesday,5,0,0,1,6
104726,Tuesday,11,0,0,0,11
104726,Tuesday,9,0,0,1,10
104727,Tuesday,11,0,0,0,11
104727,Tuesday,10,0,0,0,10
104727,Tuesday,7,0,0,1,8
104728,Tuesday,3,0,0,1,4
104728,Tuesday,9,0,0,0,9
104728,Tuesday,11,0,0,0,11
104728,Tuesday,7,0,0,0,7
104729,Tuesday,3,0,0,1,4
104729,Tuesday,7,0,0,0,7
104729,Tuesday,3,0,0,1,4
104730,Tuesday,12,0,0,0,12
104730,Tuesday,13,0,0,0,13
104730,Tuesday,3,0,0,0,3
104731,Tuesday,9,0,0,0,9
104731,Tuesday,7,0,0,1,8
104731,Tuesday,9,0,0,0,9
104731,Tuesday,9,0,0,2,11
104732,Tuesday,2,0,0,0,2
104732,Tuesday,6,0,0,0,6
104732,Tuesday,8,0,0,0,8
104733,Tuesday,9,0,0,0,9
104733,Tuesday,8,0,0,1,9
104733,Tuesday,11,0,0,0,11
104734,Tuesday,9,0,0,0,9
104734,Tuesday,9,0,0,0,9
104734,Tuesday,3,0,0,0,3
104735,Tuesday,10,0,0,0,10
104735,Tuesday,10,0,0,0,10
104735,Tuesday,13,0,0,0,13
104736,Tuesday,13,0,0,0,13
104736,Tuesday,8,0,0,1,9
104736,Tuesday,10,0,0,0,10
104737,Tuesday,7,0,0,0,7
104737,Tuesday,3,0,0,2,5
104738,Tuesday,7,0,0,1,8
104738,Tuesday,11,0,0,0,11
104738,Tuesday,2,0,0,1,3
104739,Tuesday,12,0,0,0,12
104739,Tuesday,10,0,0,0,10
104740,Tuesday,7,0,0,0,7
104740,Tuesday,7,0,0,2,9
104740,Tuesday,12,0,0,0,12
104741,Tuesday,11,0,0,0,11
104741,Tuesday,2,0,0,0,2
104741,Tuesday,11,0,0,0,11
104742,Tuesday,10,0,0,0,10
104742,Tuesday,5,0,0,2,7
104742,Tuesday,9,0,0,0,9
104743,Tuesday,6,0,0,1,7
104743,Tuesday,10,0,0,0,10
104745,Tuesday,6,0,0,1,7
104745,Tuesday,7,0,0,0,7
104745,Tuesday,13,0,0,0,13
104746,Tuesday,8,0,0,1,9
104746,Tuesday,2,0,0,1,3
104746,Tuesday,8,0,0,0,8
104747,Tuesday,8,0,0,0,8
104747,Tuesday,9,0,0,1,10
104747,Tuesday,5,0,0,0,5
104748,Tuesday,12,0,0,0,12
104748,Tuesday,3,0,0,1,4
104748,Tuesday,11,0,0,0,11
104749,Tuesday,11,0,0,1,12
104749,Tuesday,4,0,0,0,4
104749,Tuesday,11,0,0,0,11
104750,Tuesday,4,0,0,2,6
104750,Tuesday,9,0,0,0,9
104750,Tuesday,6,0,0,2,8
104751,Tuesday,12,0,0,0,12
104751,Tuesday,10,0,0,0,10
104751,Tuesday,10,0,0,0,10
104751,Tuesday,12,0,0,0,12
104752,Tuesday,9,0,0,0,9
104752,Tuesday,7,0,0,0,7
104752,Tuesday,9,0,0,0,9
104753,Tuesday,9,0,0,0,9
104753,Tuesday,8,0,0,0,8
104753,Tuesday,5,0,0,1,6
104754,Tuesday,9,0,0,0,9
104754,Tuesday,11,0,0,0,11
104754,Tuesday,12,0,0,0,12
104755,Tuesday,10,0,0,0,10
104755,Tuesday,12,0,0,0,12
104755,Tuesday,11,0,0,0,11
104755,Tuesday,12,0,0,0,12
104756,Tuesday,7,0,0,0,7
104756,Tuesday,7,0,0,0,7
104756,Tuesday,11,0,0,0,11
104757,Tuesday,12,0,0,0,12
104757,Tuesday,8,0,0,2,10
104757,Tuesday,11,0,0,0,11
104758,Tuesday,12,0,0,0,12
104758,Tuesday,3,0,0,1,4
104758,Tuesday,11,0,0,0,11
104759,Tuesday,8,0,0,1,9
104759,Tuesday,9,0,0,0,9
104759,Tuesday,12,0,0,0,12
104759,Tuesday,10,0,0,0,10
104800,Tuesday,11,0,0,0,11
104800,Tuesday,9,0,0,0,9
104800,Tuesday,12,0,0,0,12
104801,Tuesday,8,0,0,0,8
104801,Tuesday,11,0,0,0,11
104801,Tuesday,6,0,0,1,7
104802,Tuesday,8,0,0,0,8
104802,Tuesday,12,0,0,0,12
104802,Tuesday,10,0,0,0,10
104802,Tuesday,9,0,0,0,9
104803,Tuesday,7,0,0,1,8
104803,Tuesday,11,0,0,0,11
104803,Tuesday,10,0,0,0,10
104804,Tuesday,4,0,0,1,5
104804,Tuesday,5,0,0,1,6
104804,Tuesday,11,0,0,0,11
104804,Tuesday,11,0,0,0,11
104805,Tuesday,10,0,0,0,10
104805,Tuesday,6,0,0,1,7
104805,Tuesday,3,0,0,1,4
104806,Tuesday,11,0,0,0,11
104806,Tuesday,7,0,0,0,7
104806,Tuesday,12,0,0,0,12
104807,Tuesday,12,0,0,0,12
104807,Tuesday,10,0,0,0,10
104807,Tuesday,12,0,0,0,12
104807,Tuesday,11,0,0,0,11
104808,Tuesday,9,0,0,1,10
104808,Tuesday,10,0,0,0,10
104808,Tuesday,12,0,0,0,12
104809,Tuesday,11,0,0,0,11
104809,Tuesday,10,0,0,0,10
104809,Tuesday,7,0,0,0,7
104810,Tuesday,2,0,0,0,2
104810,Tuesday,7,0,0,0,7
104810,Tuesday,3,0,0,2,5
104811,Tuesday,8,0,0,0,8
104811,Tuesday,8,0,0,0,8
104811,Tuesday,11,0,0,0,11
104811,Tuesday,10,0,0,0,10
104812,Tuesday,4,0,0,1,5
104812,Tuesday,11,0,0,0,11
104812,Tuesday,10,0,0,0,10
104813,Tuesday,11,0,0,0,11
104813,Tuesday,3,0,0,1,4
104813,Tuesday,9,0,0,0,9
104814,Tuesday,12,0,0,0,12
104814,Tuesday,3,0,0,2,5
104814,Tuesday,11,0,0,0,11
104814,Tuesday,1,0,0,1,2
104815,Tuesday,3,0,0,1,4
104815,Tuesday,7,0,0,1,8
104815,Tuesday,4,0,0,1,5
104816,Tuesday,10,0,0,0,10
104816,Tuesday,9,0,0,0,9
104816,Tuesday,9,0,0,1,10
104817,Tuesday,12,0,0,0,12
104817,Tuesday,7,0,0,3,10
104819,Tuesday,11,0,0,0,11
104819,Tuesday,8,0,0,0,8
104819,Tuesday,11,0,0,0,11
104820,Tuesday,6,0,0,1,7
104820,Tuesday,11,0,0,0,11
104820,Tuesday,5,0,0,0,5
104821,Tuesday,9,0,0,0,9
104821,Tuesday,12,0,0,0,12
104821,Tuesday,7,0,0,1,8
104822,Tuesday,2,0,0,1,3
104822,Tuesday,8,0,0,0,8
104822,Tuesday,9,0,0,0,9
104823,Tuesday,7,0,0,1,8
104823,Tuesday,7,0,0,0,7
104823,Tuesday,10,0,0,0,10
104824,Tuesday,11,0,0,0,11
104824,Tuesday,9,0,0,0,9
104824,Tuesday,6,0,0,1,7
104825,Tuesday,13,0,0,0,13
104825,Tuesday,9,0,0,0,9
104825,Tuesday,6,0,0,1,7
104825,Tuesday,6,0,0,0,6
104826,Tuesday,9,0,0,1,10
104826,Tuesday,7,0,0,1,8
104826,Tuesday,2,0,0,0,2
104827,Tuesday,2,0,0,1,3
104827,Tuesday,4,0,0,0,4
104827,Tuesday,10,0,0,0,10
104828,Tuesday,7,0,0,1,8
104828,Tuesday,6,0,0,1,7
104828,Tuesday,9,0,0,2,11
104829,Tuesday,10,0,0,0,10
104829,Tuesday,8,0,0,1,9
104829,Tuesday,7,0,0,0,7
104829,Tuesday,2,0,0,1,3
104830,Tuesday,7,0,0,0,7
104830,Tuesday,10,0,0,0,10
104830,Tuesday,11,0,0,0,11
104831,Tuesday,7,0,0,2,9
104831,Tuesday,1,0,0,2,3
104831,Tuesday,13,0,0,0,13
104832,Tuesday,1,0,0,0,1
104832,Tuesday,10,0,0,0,10
104832,Tuesday,10,0,0,0,10
104833,Tuesday,8,0,0,0,8
104833,Tuesday,10,0,0,0,10
104833,Tuesday,11,0,0,0,11
104833,Tuesday,12,0,0,0,12
104834,Tuesday,6,0,0,1,7
104834,Tuesday,9,0,0,0,9
104834,Tuesday,12,0,0,0,12
104835,Tuesday,6,0,0,2,8
104835,Tuesday,9,0,0,0,9
104835,Tuesday,9,0,0,0,9
104836,Tuesday,2,0,0,1,3
104836,Tuesday,12,0,0,0,12
104836,Tuesday,4,0,0,0,4
104836,Tuesday,11,0,0,0,11
104837,Tuesday,5,0,0,1,6
104837,Tuesday,5,0,0,0,5
104837,Tuesday,10,0,0,0,10
104838,Tuesday,12,0,0,0,12
104838,Tuesday,5,0,0,1,6
104838,Tuesday,11,0,0,0,11
104839,Tuesday,9,0,0,0,9
104839,Tuesday,3,0,0,2,5
104839,Tuesday,12,0,0,0,12
104839,Tuesday,5,0,0,1,6
104840,Tuesday,9,0,0,0,9
104840,Tuesday,5,0,0,1,6
104840,Tuesday,4,0,0,0,4
104841,Tuesday,11,0,0,0,11
104841,Tuesday,4,0,0,1,5
104841,Tuesday,11,0,0,0,11
104842,Tuesday,10,0,0,0,10
104842,Tuesday,6,0,0,1,7
104842,Tuesday,11,0,0,0,11
104842,Tuesday,10,0,0,0,10
104843,Tuesday,10,0,0,0,10
104843,Tuesday,11,0,0,0,11
104843,Tuesday,8,0,0,0,8
104844,Tuesday,4,0,0,0,4
104844,Tuesday,10,0,0,0,10
104844,Tuesday,11,0,0,0,11
104845,Tuesday,11,0,0,0,11
104845,Tuesday,13,0,0,0,13
104845,Tuesday,8,0,0,0,8
104846,Tuesday,8,0,0,0,8
104846,Tuesday,11,0,0,0,11
104846,Tuesday,5,0,0,1,6
104846,Tuesday,10,0,0,0,10
104847,Tuesday,3,0,0,1,4
104847,Tuesday,5,0,0,1,6
104847,Tuesday,11,0,0,0,11
104848,Tuesday,10,0,0,0,10
104848,Tuesday,7,0,0,0,7
104848,Tuesday,11,0,0,0,11
104849,Tuesday,7,0,0,0,7
104849,Tuesday,9,0,0,0,9
104849,Tuesday,9,0,0,0,9
104850,Tuesday,8,0,0,0,8
104850,Tuesday,11,0,0,0,11
104850,Tuesday,7,0,0,0,7
104850,Tuesday,4,0,0,0,4
104852,Tuesday,10,0,0,0,10
104853,Tuesday,10,0,0,0,10
104853,Tuesday,11,0,0,0,11
104853,Tuesday,3,0,0,1,4
104854,Tuesday,8,0,0,0,8
104854,Tuesday,6,0,0,1,7
104855,Tuesday,10,0,0,0,10
104855,Tuesday,11,0,0,0,11
104855,Tuesday,3,0,0,1,4
104856,Tuesday,3,0,0,0,3
104856,Tuesday,8,0,0,0,8
104857,Tuesday,3,0,0,2,5
104857,Tuesday,11,0,0,0,11
104857,Tuesday,4,0,0,1,5
104858,Tuesday,12,0,0,0,12
104858,Tuesday,9,0,0,0,9
104858,Tuesday,10,0,1,0,11
104859,Tuesday,2,0,0,0,2
104859,Tuesday,3,0,0,1,4
104859,Tuesday,9,0,0,0,9
104900,Tuesday,11,0,0,0,11
104900,Tuesday,10,0,0,0,10
104900,Tuesday,11,0,0,0,11
104901,Tuesday,11,0,0,0,11
104901,Tuesday,2,0,0,0,2
104901,Tuesday,10,0,0,0,10
104902,Tuesday,11,0,0,1,12
104902,Tuesday,10,0,0,0,10
104903,Tuesday,12,0,0,0,12
104903,Tuesday,12,0,0,0,12
104904,Tuesday,8,0,0,1,9
104904,Tuesday,11,0,0,0,11
104905,Tuesday,9,0,0,1,10
104905,Tuesday,4,0,0,0,4
104906,Tuesday,8,0,0,1,9
104906,Tuesday,7,0,0,2,9
104907,Tuesday,7,0,0,0,7
104907,Tuesday,10,0,0,0,10
104907,Tuesday,10,0,1,0,11
104908,Tuesday,9,0,0,0,9
104908,Tuesday,13,0,0,0,13
104908,Tuesday,9,0,0,0,9
104909,Tuesday,10,0,1,0,11
104909,Tuesday,8,0,0,0,8
104910,Tuesday,7,0,0,2,9
104910,Tuesday,9,0,0,0,9
104910,Tuesday,5,0,0,2,7
104911,Tuesday,7,0,0,0,7
104911,Tuesday,3,0,0,0,3
104911,Tuesday,12,0,0,0,12
104911,Tuesday,12,0,0,0,12
104912,Tuesday,2,0,0,0,2
104912,Tuesday,4,0,0,1,5
104912,Tuesday,11,0,0,0,11
104913,Tuesday,7,0,0,1,8
104913,Tuesday,11,0,0,0,11
104913,Tuesday,8,0,0,0,8
104914,Tuesday,8,0,0,3,11
104914,Tuesday,7,0,0,0,7
104914,Tuesday,12,0,0,0,12
104914,Tuesday,9,0,0,0,9
104915,Tuesday,10,0,0,0,10
104915,Tuesday,8,0,0,2,10
104915,Tuesday,4,0,0,1,5
104916,Tuesday,12,0,0,0,12
104916,Tuesday,8,0,0,0,8
104916,Tuesday,8,0,0,0,8
104917,Tuesday,7,0,0,0,7
104917,Tuesday,5,0,0,2,7
104917,Tuesday,2,0,0,1,3
104917,Tuesday,7,0,0,1,8
104918,Tuesday,10,0,0,0,10
104918,Tuesday,9,0,0,0,9
104918,Tuesday,10,0,0,0,10
104919,Tuesday,10,0,0,0,10
104919,Tuesday,11,0,0,0,11
104919,Tuesday,9,0,0,1,10
104920,Tuesday,9,0,0,0,9
104920,Tuesday,10,0,0,0,10
104920,Tuesday,11,0,0,0,11
104921,Tuesday,8,0,0,2,10
104921,Tuesday,3,0,0,1,4
104921,Tuesday,5,0,0,1,6
104922,Tuesday,11,0,0,0,11
104922,Tuesday,9,0,0,0,9
104922,Tuesday,8,0,0,1,9
104922,Tuesday,8,0,0,0,8
104923,Tuesday,9,0,0,0,9
104923,Tuesday,3,0,0,1,4
104923,Tuesday,5,0,0,1,6
104924,Tuesday,3,0,0,1,4
104924,Tuesday,5,0,0,1,6
104924,Tuesday,2,0,0,2,4
104925,Tuesday,3,0,0,2,5
104927,Tuesday,5,0,0,0,5
104927,Tuesday,11,0,0,0,11
104927,Tuesday,7,0,0,2,9
104928,Tuesday,12,0,0,0,12
104928,Tuesday,12,0,0,0,12
104928,Tuesday,10,0,0,0,10
104929,Tuesday,10,0,0,0,10
104929,Tuesday,10,0,0,0,10
104929,Tuesday,10,0,0,0,10
104930,Tuesday,11,0,0,0,11
104930,Tuesday,8,0,0,2,10
104930,Tuesday,8,0,0,0,8
104931,Tuesday,2,0,0,1,3
104931,Tuesday,10,0,0,0,10
104931,Tuesday,6,0,0,1,7
104931,Tuesday,7,0,0,3,10
104932,Tuesday,13,0,0,0,13
104932,Tuesday,7,0,0,0,7
104932,Tuesday,7,0,0,0,7
104933,Tuesday,10,0,0,1,11
104933,Tuesday,12,0,0,0,12
104933,Tuesday,3,0,0,0,3
104934,Tuesday,12,0,0,0,12
104934,Tuesday,3,0,0,2,5
104934,Tuesday,12,0,0,0,12
104935,Tuesday,9,0,0,0,9
104935,Tuesday,7,0,0,1,8
104935,Tuesday,8,0,0,0,8
104935,Tuesday,7,0,0,0,7
104936,Tuesday,8,0,0,0,8
104936,Tuesday,9,0,0,0,9
104936,Tuesday,2,0,0,2,4
104937,Tuesday,8,0,0,0,8
104937,Tuesday,7,0,0,1,8
104937,Tuesday,10,0,0,0,10
104938,Tuesday,8,0,0,2,10
104938,Tuesday,8,0,0,0,8
104938,Tuesday,10,0,0,0,10
104938,Tuesday,10,0,0,1,11
104939,Tuesday,9,0,0,0,9
104939,Tuesday,8,0,0,1,9
104939,Tuesday,11,0,0,0,11
104940,Tuesday,11,0,0,0,11
104940,Tuesday,9,0,0,1,10
104940,Tuesday,8,0,0,1,9
104941,Tuesday,10,0,0,0,10
104941,Tuesday,12,0,0,0,12
104941,Tuesday,10,0,0,0,10
104941,Tuesday,8,0,0,0,8
104942,Tuesday,4,0,0,2,6
104942,Tuesday,5,0,0,1,6
104942,Tuesday,8,0,0,0,8
104943,Tuesday,9,0,0,1,10
104943,Tuesday,4,0,0,0,4
104943,Tuesday,11,0,0,0,11
104944,Tuesday,4,0,0,2,6
104944,Tuesday,3,0,0,2,5
104944,Tuesday,7,0,0,0,7
104944,Tuesday,10,0,0,0,10
104945,Tuesday,9,0,0,0,9
104945,Tuesday,10,0,0,0,10
104945,Tuesday,10,0,0,0,10
104946,Tuesday,2,0,0,0,2
104946,Tuesday,9,0,0,0,9
104946,Tuesday,8,0,0,1,9
104947,Tuesday,3,0,0,2,5
104947,Tuesday,6,0,0,1,7
104947,Tuesday,5,0,0,2,7
104947,Tuesday,7,0,0,0,7
104948,Tuesday,9,0,0,0,9
104948,Tuesday,11,0,0,0,11
104948,Tuesday,10,0,0,0,10
104949,Tuesday,8,0,0,0,8
104949,Tuesday,7,0,0,1,8
104949,Tuesday,9,0,0,2,11
104950,Tuesday,6,0,0,1,7
104950,Tuesday,7,0,0,1,8
104950,Tuesday,7,0,0,2,9
104950,Tuesday,4,0,0,0,4
104951,Tuesday,11,0,0,0,11
104951,Tuesday,11,0,0,0,11
104951,Tuesday,12,0,0,0,12
104952,Tuesday,3,0,0,0,3
104952,Tuesday,7,0,0,1,8
104952,Tuesday,9,0,0,1,10
104953,Tuesday,6,0,0,1,7
104953,Tuesday,8,0,0,0,8
104953,Tuesday,12,0,0,0,12
104954,Tuesday,10,0,0,0,10
104954,Tuesday,3,0,0,1,4
104954,Tuesday,12,0,0,0,12
104955,Tuesday,11,0,0,0,11
104955,Tuesday,5,0,0,0,5
104955,Tuesday,11,0,0,0,11
104956,Tuesday,12,0,0,0,12
104956,Tuesday,8,0,0,0,8
104956,Tuesday,8,0,0,0,8
104956,Tuesday,5,0,0,0,5
104957,Tuesday,10,0,0,0,10
104957,Tuesday,10,0,1,0,11
104957,Tuesday,9,0,0,0,9
104958,Tuesday,4,0,0,1,5
104958,Tuesday,9,0,0,1,10
104958,Tuesday,11,0,0,0,11
105000,Tuesday,6,0,1,1,8
105001,Tuesday,8,0,0,0,8
105001,Tuesday,11,0,0,0,11
105001,Tuesday,11,0,0,0,11
105002,Tuesday,7,0,0,0,7
105002,Tuesday,7,0,0,1,8
105002,Tuesday,11,0,0,0,11
105003,Tuesday,6,0,0,1,7
105003,Tuesday,9,0,0,0,9
105003,Tuesday,4,0,0,2,6
105004,Tuesday,6,0,0,1,7
105004,Tuesday,9,0,0,0,9
105004,Tuesday,11,0,0,0,11
105005,Tuesday,6,0,0,1,7
105005,Tuesday,8,0,0,0,8
105005,Tuesday,9,0,0,0,9
105005,Tuesday,11,0,0,0,11
105006,Tuesday,8,0,0,0,8
105006,Tuesday,3,0,0,0,3
105006,Tuesday,3,0,0,2,5
105007,Tuesday,9,0,0,0,9
105007,Tuesday,11,0,0,0,11
105007,Tuesday,9,0,0,0,9
105008,Tuesday,2,0,0,1,3
105008,Tuesday,8,0,0,1,9
105008,Tuesday,2,0,0,2,4
105008,Tuesday,12,0,0,0,12
105009,Tuesday,8,0,0,1,9
105009,Tuesday,9,0,0,1,10
105009,Tuesday,1,0,0,0,1
105010,Tuesday,2,0,0,1,3
105010,Tuesday,11,0,0,1,12
105010,Tuesday,9,0,0,0,9
105011,Tuesday,7,0,0,2,9
105011,Tuesday,13,0,0,0,13
105011,Tuesday,8,0,0,1,9
105011,Tuesday,10,0,0,0,10
105012,Tuesday,4,0,0,2,6
105012,Tuesday,9,0,0,0,9
105012,Tuesday,7,0,0,2,9
105013,Tuesday,5,0,0,1,6
105013,Tuesday,12,0,0,0,12
105013,Tuesday,10,0,0,0,10
105014,Tuesday,9,0,0,1,10
105014,Tuesday,11,0,0,0,11
105014,Tuesday,6,0,0,1,7
105014,Tuesday,11,0,0,0,11
105015,Tuesday,10,0,0,0,10
105015,Tuesday,12,0,0,0,12
105015,Tuesday,6,0,0,1,7
105016,Tuesday,3,0,0,2,5
105016,Tuesday,13,0,0,0,13
105016,Tuesday,3,0,0,1,4
105017,Tuesday,9,0,0,0,9
105017,Tuesday,11,0,0,0,11
105017,Tuesday,4,0,0,0,4
105018,Tuesday,10,0,0,0,10
105018,Tuesday,10,0,0,0,10
105018,Tuesday,8,0,0,0,8
105018,Tuesday,12,0,0,0,12
105019,Tuesday,9,0,0,0,9
105019,Tuesday,3,0,0,2,5
105019,Tuesday,9,0,0,0,9
105020,Tuesday,2,0,0,0,2
105020,Tuesday,2,0,0,2,4
105020,Tuesday,10,0,0,0,10
105021,Tuesday,5,0,0,2,7
105021,Tuesday,6,0,0,1,7
105021,Tuesday,5,0,0,1,6
105022,Tuesday,10,0,0,0,10
105022,Tuesday,10,0,0,0,10
105023,Tuesday,8,0,0,0,8
105023,Tuesday,3,0,0,2,5
105024,Tuesday,2,0,0,0,2
