Time,Day of the week,CarCount,BikeCount,BusCount,TruckCount,Total
114157,Wednesday,20,0,0,0,20
114157,Wednesday,20,0,0,2,22
114157,Wednesday,21,0,0,0,21
114158,Wednesday,19,0,0,2,21
114158,Wednesday,14,0,0,3,17
114158,Wednesday,18,0,0,1,19
114158,Wednesday,17,0,0,3,20
114159,Wednesday,25,0,0,0,25
114159,Wednesday,25,0,0,1,26
114159,Wednesday,15,0,0,3,18
114159,Wednesday,18,0,0,2,20
114200,Wednesday,21,0,0,2,23
114200,Wednesday,17,0,1,2,20
114200,Wednesday,26,0,0,0,26
114201,Wednesday,23,0,0,1,24
114201,Wednesday,15,0,0,2,17
114201,Wednesday,13,0,0,2,15
114201,Wednesday,14,0,0,3,17
114202,Wednesday,23,0,0,2,25
114202,Wednesday,21,0,0,0,21
114202,Wednesday,19,0,0,1,20
114202,Wednesday,20,0,0,0,20
114203,Wednesday,16,0,0,3,19
114203,Wednesday,16,0,0,2,18
114203,Wednesday,19,0,0,2,21
114203,Wednesday,22,0,0,0,22
114204,Wednesday,16,0,0,1,17
114204,Wednesday,20,0,0,2,22
114204,Wednesday,25,0,0,0,25
114205,Wednesday,22,0,0,0,22
114205,Wednesday,20,0,0,2,22
114205,Wednesday,22,0,0,1,23
114205,Wednesday,23,0,0,2,25
114206,Wednesday,18,0,0,3,21
114206,Wednesday,26,1,0,2,29
114206,Wednesday,20,0,0,3,23
114206,Wednesday,17,0,0,0,17
114207,Wednesday,19,0,0,0,19
114207,Wednesday,16,0,0,4,20
114207,Wednesday,20,0,0,2,22
114207,Wednesday,16,0,0,1,17
114208,Wednesday,25,1,0,2,28
114208,Wednesday,16,0,0,1,17
114208,Wednesday,14,0,0,5,19
114209,Wednesday,17,0,0,2,19
114209,Wednesday,18,0,0,4,22
114209,Wednesday,13,0,0,3,16
114209,Wednesday,27,0,0,0,27
114210,Wednesday,23,0,0,2,25
114210,Wednesday,18,0,0,3,21
114210,Wednesday,18,0,0,3,21
114210,Wednesday,12,0,0,2,14
114211,Wednesday,20,0,0,2,22
114211,Wednesday,20,0,0,2,22
114211,Wednesday,22,0,0,0,22
114211,Wednesday,14,0,0,1,15
114212,Wednesday,18,0,0,1,19
114212,Wednesday,18,0,0,1,19
114212,Wednesday,23,0,0,0,23
114212,Wednesday,17,0,1,1,19
114213,Wednesday,25,0,0,1,26
114213,Wednesday,16,0,0,2,18
114213,Wednesday,20,0,0,2,22
114214,Wednesday,20,0,0,1,21
114214,Wednesday,19,0,0,0,19
114214,Wednesday,22,1,0,2,25
114215,Wednesday,20,0,0,2,22
114215,Wednesday,17,0,0,2,19
114215,Wednesday,16,0,0,2,18
114215,Wednesday,20,0,0,1,21
114216,Wednesday,24,0,0,0,24
114216,Wednesday,17,0,0,0,17
114216,Wednesday,17,0,0,2,19
114216,Wednesday,19,0,0,1,20
114217,Wednesday,20,0,0,4,24
114217,Wednesday,24,0,0,1,25
114217,Wednesday,16,0,0,2,18
114218,Wednesday,14,0,0,3,17
114218,Wednesday,16,0,0,1,17
114218,Wednesday,23,0,0,2,25
114218,Wednesday,24,0,0,0,24
114219,Wednesday,16,0,0,1,17
114219,Wednesday,18,0,0,1,19
114219,Wednesday,23,0,0,2,25
114219,Wednesday,25,0,0,0,25
114220,Wednesday,20,0,0,1,21
114220,Wednesday,17,0,0,4,21
114220,Wednesday,18,0,0,2,20
114221,Wednesday,22,0,0,2,24
114221,Wednesday,14,0,0,4,18
114221,Wednesday,16,0,0,3,19
114221,Wednesday,18,0,0,2,20
114222,Wednesday,22,0,0,0,22
114222,Wednesday,24,0,0,2,26
114222,Wednesday,17,0,0,2,19
114222,Wednesday,16,0,0,1,17
114223,Wednesday,13,0,0,2,15
114223,Wednesday,23,0,0,2,25
114223,Wednesday,17,0,0,2,19
114223,Wednesday,17,0,0,3,20
114224,Wednesday,22,0,0,2,24
114224,Wednesday,21,0,0,2,23
114224,Wednesday,18,0,0,1,19
114224,Wednesday,24,0,0,2,26
114225,Wednesday,18,0,0,1,19
114225,Wednesday,19,0,0,1,20
114225,Wednesday,25,0,0,0,25
114226,Wednesday,20,0,0,1,21
114226,Wednesday,25,0,0,0,25
114226,Wednesday,19,0,0,2,21
114226,Wednesday,25,0,0,0,25
114227,Wednesday,18,0,0,1,19
114227,Wednesday,16,0,0,2,18
114227,Wednesday,22,0,0,2,24
114227,Wednesday,17,0,1,3,21
114228,Wednesday,16,0,0,1,17
114228,Wednesday,20,0,0,2,22
114228,Wednesday,15,0,0,1,16
114229,Wednesday,16,0,0,3,19
114229,Wednesday,22,0,0,0,22
114229,Wednesday,17,0,0,5,22
114229,Wednesday,13,0,0,2,15
114230,Wednesday,20,0,0,0,20
114230,Wednesday,19,0,0,3,22
114230,Wednesday,20,0,0,4,24
114230,Wednesday,14,0,0,3,17
114231,Wednesday,23,0,0,2,25
114231,Wednesday,23,0,0,2,25
114231,Wednesday,20,0,0,1,21
114231,Wednesday,17,0,0,3,20
114232,Wednesday,23,0,0,2,25
114232,Wednesday,22,0,0,2,24
114232,Wednesday,14,0,0,3,17
114233,Wednesday,19,0,0,2,21
114233,Wednesday,16,0,0,2,18
114233,Wednesday,21,0,0,2,23
114233,Wednesday,21,0,0,1,22
114234,Wednesday,15,0,0,4,19
114234,Wednesday,16,0,0,2,18
114234,Wednesday,24,0,0,0,24
114234,Wednesday,17,0,1,2,20
114235,Wednesday,22,0,0,0,22
114235,Wednesday,18,0,0,3,21
114235,Wednesday,16,0,0,2,18
114235,Wednesday,18,0,0,1,19
114236,Wednesday,15,0,0,1,16
114236,Wednesday,20,0,0,0,20
114236,Wednesday,23,0,0,0,23
114236,Wednesday,14,0,0,2,16
114237,Wednesday,24,0,0,0,24
114237,Wednesday,17,0,0,2,19
114237,Wednesday,21,0,0,1,22
114238,Wednesday,14,0,0,3,17
114238,Wednesday,15,0,0,1,16
114238,Wednesday,16,0,0,1,17
114238,Wednesday,23,0,0,2,25
114239,Wednesday,24,0,0,0,24
114239,Wednesday,23,0,0,0,23
114239,Wednesday,23,0,0,1,24
114239,Wednesday,21,0,0,2,23
114240,Wednesday,15,0,0,2,17
114240,Wednesday,19,0,0,6,25
114240,Wednesday,16,0,0,2,18
114240,Wednesday,19,0,0,0,19
114241,Wednesday,25,0,0,0,25
114241,Wednesday,22,0,0,1,23
114241,Wednesday,16,0,0,1,17
114242,Wednesday,20,0,0,2,22
114242,Wednesday,22,0,0,0,22
114242,Wednesday,19,0,0,1,20
114242,Wednesday,18,0,0,2,20
114243,Wednesday,21,0,0,1,22
114243,Wednesday,24,0,0,2,26
114243,Wednesday,18,0,0,2,20
114243,Wednesday,17,0,0,0,17
114244,Wednesday,22,0,0,1,23
114244,Wednesday,21,0,0,0,21
114244,Wednesday,17,0,0,2,19
114244,Wednesday,16,0,0,1,17
114245,Wednesday,24,0,0,0,24
114245,Wednesday,17,0,0,2,19
114245,Wednesday,16,0,0,1,17
114246,Wednesday,23,0,0,0,23
114246,Wednesday,25,0,0,0,25
114246,Wednesday,18,0,0,3,21
114246,Wednesday,21,0,0,0,21
114247,Wednesday,19,0,0,0,19
114247,Wednesday,25,0,0,0,25
114247,Wednesday,17,0,0,2,19
114247,Wednesday,19,0,0,1,20
114248,Wednesday,19,0,0,1,20
114248,Wednesday,19,0,0,1,20
114248,Wednesday,21,0,1,2,24
114248,Wednesday,22,0,0,1,23
114249,Wednesday,14,0,0,3,17
114249,Wednesday,24,0,0,2,26
114249,Wednesday,22,0,0,2,24
114250,Wednesday,16,0,0,1,17
114250,Wednesday,25,0,0,0,25
114250,Wednesday,20,0,0,3,23
114250,Wednesday,20,0,0,3,23
114251,Wednesday,17,0,0,1,18
114251,Wednesday,21,0,0,0,21
114251,Wednesday,22,0,0,2,24
114251,Wednesday,14,0,0,4,18
114252,Wednesday,20,0,0,0,20
114252,Wednesday,17,0,0,1,18
114252,Wednesday,14,0,0,2,16
114252,Wednesday,25,0,0,1,26
114253,Wednesday,22,0,0,0,22
114253,Wednesday,20,0,0,0,20
114253,Wednesday,18,0,0,3,21
114254,Wednesday,21,0,0,2,23
114254,Wednesday,16,0,0,2,18
114254,Wednesday,25,0,0,0,25
114254,Wednesday,20,0,0,0,20
114255,Wednesday,23,0,0,2,25
114255,Wednesday,14,0,0,6,20
114255,Wednesday,21,0,0,0,21
114255,Wednesday,16,0,0,3,19
114256,Wednesday,23,0,0,0,23
114256,Wednesday,20,0,0,0,20
114256,Wednesday,13,0,0,2,15
114256,Wednesday,23,0,0,0,23
114257,Wednesday,16,0,0,1,17
114257,Wednesday,22,0,0,2,24
114257,Wednesday,20,0,0,3,23
114258,Wednesday,18,0,0,1,19
114258,Wednesday,24,0,0,0,24
114258,Wednesday,17,0,0,3,20
114258,Wednesday,21,0,0,2,23
114259,Wednesday,20,0,0,3,23
114259,Wednesday,17,0,0,2,19
114259,Wednesday,17,0,0,2,19
114259,Wednesday,21,0,0,1,22
114300,Wednesday,16,0,0,2,18
114300,Wednesday,20,0,0,2,22
114300,Wednesday,17,0,0,3,20
114301,Wednesday,18,0,0,0,18
114301,Wednesday,20,0,0,1,21
114301,Wednesday,21,0,0,0,21
114301,Wednesday,25,0,0,0,25
114302,Wednesday,18,0,0,2,20
114302,Wednesday,14,0,0,1,15
114302,Wednesday,20,0,0,2,22
114303,Wednesday,23,0,0,2,25
114303,Wednesday,17,0,0,2,19
114303,Wednesday,14,0,0,2,16
114303,Wednesday,18,0,0,3,21
114304,Wednesday,24,1,0,1,26
114304,Wednesday,14,0,0,1,15
114304,Wednesday,26,1,0,0,27
114304,Wednesday,13,0,0,3,16
114305,Wednesday,17,0,0,3,20
114305,Wednesday,20,0,0,4,24
114305,Wednesday,18,0,0,2,20
114306,Wednesday,19,0,0,2,21
114306,Wednesday,19,0,0,4,23
114306,Wednesday,24,0,0,0,24
114306,Wednesday,17,0,0,3,20
114307,Wednesday,16,0,0,3,19
114307,Wednesday,14,0,0,1,15
114307,Wednesday,21,0,0,1,22
114308,Wednesday,16,0,0,1,17
114308,Wednesday,19,0,0,0,19
114308,Wednesday,19,0,0,4,23
114308,Wednesday,17,0,0,3,20
114309,Wednesday,14,0,0,2,16
114309,Wednesday,21,0,0,2,23
114309,Wednesday,18,0,0,2,20
114310,Wednesday,23,0,0,0,23
114310,Wednesday,26,0,0,0,26
114310,Wednesday,13,0,0,3,16
114311,Wednesday,19,0,0,2,21
114311,Wednesday,18,0,0,3,21
114311,Wednesday,16,0,0,2,18
114311,Wednesday,21,0,0,1,22
114312,Wednesday,19,0,0,3,22
114312,Wednesday,21,0,0,2,23
114312,Wednesday,22,0,0,0,22
114313,Wednesday,14,0,0,3,17
114313,Wednesday,18,0,0,3,21
114313,Wednesday,18,0,0,3,21
114313,Wednesday,18,0,0,1,19
114314,Wednesday,18,0,0,1,19
114314,Wednesday,23,0,0,2,25
114314,Wednesday,16,0,0,3,19
114314,Wednesday,21,0,0,2,23
114315,Wednesday,17,0,0,2,19
114315,Wednesday,23,0,0,0,23
114315,Wednesday,27,0,0,0,27
114316,Wednesday,22,0,0,0,22
114316,Wednesday,21,0,0,2,23
114316,Wednesday,14,0,0,2,16
114316,Wednesday,21,0,0,1,22
114317,Wednesday,21,0,1,2,24
114317,Wednesday,17,0,0,2,19
114317,Wednesday,22,0,1,1,24
114318,Wednesday,19,0,0,2,21
114318,Wednesday,15,0,0,2,17
114318,Wednesday,24,0,0,0,24
114318,Wednesday,18,0,0,1,19
114319,Wednesday,23,0,0,0,23
114319,Wednesday,16,0,0,1,17
114319,Wednesday,23,1,0,0,24
114319,Wednesday,22,0,0,2,24
114320,Wednesday,17,0,0,3,20
114320,Wednesday,21,0,0,3,24
114320,Wednesday,21,0,0,0,21
114321,Wednesday,20,0,0,2,22
114321,Wednesday,20,0,0,1,21
114321,Wednesday,18,0,0,4,22
114321,Wednesday,16,0,0,2,18
114322,Wednesday,16,0,0,2,18
114322,Wednesday,23,0,0,0,23
114322,Wednesday,20,0,0,3,23
114322,Wednesday,17,0,0,1,18
114323,Wednesday,17,0,0,3,20
114323,Wednesday,23,0,0,0,23
114323,Wednesday,22,0,0,0,22
114324,Wednesday,18,0,0,1,19
114324,Wednesday,18,0,0,1,19
114324,Wednesday,15,0,0,3,18
114324,Wednesday,18,0,0,2,20
114325,Wednesday,20,0,0,1,21
114325,Wednesday,16,0,0,1,17
114325,Wednesday,22,0,0,0,22
114325,Wednesday,22,0,0,2,24
114326,Wednesday,21,0,0,1,22
114326,Wednesday,24,0,0,1,25
114326,Wednesday,14,0,0,1,15
114327,Wednesday,20,0,0,0,20
114327,Wednesday,21,0,0,2,23
114327,Wednesday,15,0,0,5,20
114327,Wednesday,18,0,0,2,20
114328,Wednesday,24,0,0,0,24
114328,Wednesday,14,0,0,4,18
114328,Wednesday,20,0,0,2,22
114328,Wednesday,23,0,0,0,23
114329,Wednesday,15,0,0,3,18
114329,Wednesday,18,0,0,2,20
114329,Wednesday,21,0,0,2,23
114330,Wednesday,14,0,0,3,17
114330,Wednesday,24,0,0,0,24
114330,Wednesday,14,0,0,3,17
114330,Wednesday,17,0,0,2,19
114331,Wednesday,24,0,0,1,25
114331,Wednesday,19,0,0,0,19
114331,Wednesday,21,0,0,0,21
114332,Wednesday,22,0,0,0,22
114332,Wednesday,25,0,0,1,26
114332,Wednesday,18,0,0,4,22
114332,Wednesday,21,0,1,1,23
114333,Wednesday,20,0,0,5,25
114333,Wednesday,23,0,0,2,25
114333,Wednesday,26,0,0,2,28
114333,Wednesday,22,0,0,2,24
114334,Wednesday,19,0,0,3,22
114334,Wednesday,20,0,1,2,23
114334,Wednesday,20,0,0,0,20
114335,Wednesday,15,0,0,0,15
114335,Wednesday,17,0,0,2,19
114335,Wednesday,15,0,0,2,17
114335,Wednesday,18,0,0,3,21
114336,Wednesday,19,0,0,0,19
114336,Wednesday,22,0,0,0,22
114336,Wednesday,19,0,0,2,21
114336,Wednesday,14,0,0,2,16
114337,Wednesday,20,0,0,2,22
114337,Wednesday,17,0,0,1,18
114337,Wednesday,19,0,0,1,20
114338,Wednesday,15,0,0,2,17
114338,Wednesday,23,0,0,0,23
114338,Wednesday,21,0,0,0,21
114338,Wednesday,18,0,0,2,20
114339,Wednesday,19,0,1,3,23
114339,Wednesday,25,0,0,1,26
114339,Wednesday,17,0,0,1,18
114339,Wednesday,22,0,0,2,24
114340,Wednesday,21,0,0,0,21
114340,Wednesday,22,0,0,0,22
114340,Wednesday,24,0,0,0,24
114341,Wednesday,19,0,0,3,22
114341,Wednesday,23,0,0,2,25
114341,Wednesday,17,0,0,6,23
114341,Wednesday,16,0,0,2,18
114342,Wednesday,21,0,0,2,23
114342,Wednesday,26,0,0,0,26
114342,Wednesday,21,0,0,0,21
114343,Wednesday,21,0,0,1,22
114343,Wednesday,21,0,0,3,24
114343,Wednesday,13,0,0,2,15
114343,Wednesday,15,0,0,3,18
114344,Wednesday,22,0,0,2,24
114344,Wednesday,17,0,0,1,18
114344,Wednesday,14,0,0,1,15
114345,Wednesday,25,0,0,0,25
114345,Wednesday,22,0,0,1,23
114345,Wednesday,16,0,0,2,18
114345,Wednesday,16,0,0,2,18
114346,Wednesday,17,0,0,2,19
114346,Wednesday,17,0,0,0,17
114346,Wednesday,24,0,0,1,25
114346,Wednesday,18,0,0,2,20
114347,Wednesday,25,0,0,0,25
114347,Wednesday,21,0,0,0,21
114347,Wednesday,21,0,0,4,25
114348,Wednesday,16,0,0,4,20
114348,Wednesday,20,0,0,3,23
114348,Wednesday,16,0,0,2,18
114348,Wednesday,25,0,0,0,25
114349,Wednesday,21,0,0,3,24
114349,Wednesday,15,0,0,3,18
114349,Wednesday,24,0,0,1,25
114350,Wednesday,15,0,0,2,17
114350,Wednesday,18,0,0,2,20
114350,Wednesday,24,0,0,2,26
114350,Wednesday,15,0,0,2,17
114351,Wednesday,15,0,0,2,17
114351,Wednesday,21,0,0,0,21
114351,Wednesday,13,0,0,2,15
114351,Wednesday,19,0,0,3,22
114352,Wednesday,17,0,0,1,18
114352,Wednesday,13,0,0,1,14
114352,Wednesday,22,0,0,0,22
114353,Wednesday,25,0,0,2,27
114353,Wednesday,22,0,0,2,24
114353,Wednesday,23,0,0,0,23
114353,Wednesday,22,0,0,0,22
114354,Wednesday,18,0,0,3,21
114354,Wednesday,16,0,0,2,18
114354,Wednesday,21,0,0,2,23
114354,Wednesday,16,0,1,2,19
114355,Wednesday,21,0,0,1,22
114355,Wednesday,19,0,0,4,23
114355,Wednesday,19,0,0,3,22
114356,Wednesday,15,0,0,4,19
114356,Wednesday,19,0,0,1,20
114356,Wednesday,23,0,0,0,23
114356,Wednesday,15,0,0,2,17
114357,Wednesday,18,0,0,1,19
114357,Wednesday,14,0,0,3,17
114357,Wednesday,19,0,0,0,19
114358,Wednesday,18,0,0,2,20
114358,Wednesday,15,0,0,4,19
114358,Wednesday,16,0,0,3,19
114358,Wednesday,17,0,0,2,19
114359,Wednesday,13,0,0,3,16
114359,Wednesday,21,0,0,1,22
114359,Wednesday,24,0,0,0,24
114359,Wednesday,26,0,0,1,27
114400,Wednesday,25,0,0,0,25
114400,Wednesday,20,0,0,3,23
114400,Wednesday,19,0,0,2,21
114401,Wednesday,22,0,0,2,24
114401,Wednesday,18,0,0,0,18
114401,Wednesday,20,0,0,0,20
114401,Wednesday,21,0,0,2,23
114402,Wednesday,20,0,0,2,22
114402,Wednesday,17,0,0,3,20
114402,Wednesday,19,0,0,1,20
114402,Wednesday,21,0,0,1,22
114403,Wednesday,18,0,0,1,19
114403,Wednesday,22,0,0,2,24
114403,Wednesday,22,0,0,0,22
114404,Wednesday,23,0,0,0,23
114404,Wednesday,25,1,0,1,27
114404,Wednesday,20,0,0,1,21
114404,Wednesday,19,0,1,5,25
114405,Wednesday,24,0,0,0,24
114405,Wednesday,13,0,0,1,14
114405,Wednesday,20,0,0,2,22
114406,Wednesday,18,0,0,1,19
114406,Wednesday,21,0,0,0,21
114406,Wednesday,15,0,0,3,18
114406,Wednesday,18,0,0,3,21
114407,Wednesday,15,0,0,3,18
114407,Wednesday,20,0,0,1,21
114407,Wednesday,20,0,0,3,23
114407,Wednesday,18,0,0,3,21
114408,Wednesday,27,0,0,1,28
114408,Wednesday,18,0,0,3,21
114408,Wednesday,24,2,0,2,28
114409,Wednesday,18,0,0,3,21
114409,Wednesday,24,0,0,1,25
114409,Wednesday,17,0,0,2,19
114409,Wednesday,19,0,0,0,19
114410,Wednesday,14,0,0,3,17
114410,Wednesday,26,0,0,0,26
114410,Wednesday,21,0,0,0,21
114411,Wednesday,22,0,0,0,22
114411,Wednesday,18,0,0,2,20
114411,Wednesday,15,0,0,3,18
114411,Wednesday,19,0,0,0,19
114412,Wednesday,23,0,0,0,23
114412,Wednesday,20,0,0,0,20
114412,Wednesday,19,0,0,3,22
114412,Wednesday,23,0,0,0,23
114413,Wednesday,21,0,0,2,23
114413,Wednesday,18,0,0,2,20
114413,Wednesday,23,0,0,0,23
114414,Wednesday,20,0,1,1,22
114414,Wednesday,15,0,0,2,17
114414,Wednesday,21,0,0,2,23
114414,Wednesday,18,0,0,3,21
114415,Wednesday,20,0,0,2,22
114415,Wednesday,14,0,0,2,16
114415,Wednesday,19,0,0,3,22
114415,Wednesday,22,0,0,3,25
114416,Wednesday,20,0,0,1,21
114416,Wednesday,21,0,0,2,23
114416,Wednesday,15,0,0,1,16
114417,Wednesday,18,0,0,2,20
114417,Wednesday,18,0,0,0,18
114417,Wednesday,18,0,0,2,20
114417,Wednesday,23,0,0,0,23
114418,Wednesday,23,0,0,0,23
114418,Wednesday,16,0,0,1,17
114418,Wednesday,18,0,0,1,19
114418,Wednesday,16,0,0,3,19
114419,Wednesday,23,0,0,0,23
114419,Wednesday,16,0,0,2,18
114419,Wednesday,17,0,0,3,20
114420,Wednesday,19,0,0,0,19
114420,Wednesday,18,0,0,3,21
114420,Wednesday,17,0,0,2,19
114420,Wednesday,16,0,0,1,17
114421,Wednesday,22,0,0,0,22
114421,Wednesday,19,0,0,1,20
114421,Wednesday,21,0,0,2,23
114422,Wednesday,16,0,0,2,18
114422,Wednesday,18,0,0,2,20
114422,Wednesday,22,0,0,0,22
114422,Wednesday,19,0,0,3,22
114423,Wednesday,20,0,0,0,20
114423,Wednesday,17,0,0,2,19
114423,Wednesday,24,0,0,0,24
114423,Wednesday,25,0,0,1,26
114424,Wednesday,19,0,0,3,22
114424,Wednesday,22,0,0,2,24
114424,Wednesday,22,0,0,2,24
114425,Wednesday,21,0,0,0,21
114425,Wednesday,15,0,0,1,16
114425,Wednesday,22,0,0,2,24
114425,Wednesday,19,0,0,1,20
114426,Wednesday,14,0,0,4,18
114426,Wednesday,24,0,0,0,24
114426,Wednesday,19,0,0,0,19
114427,Wednesday,23,0,0,2,25
114427,Wednesday,21,0,0,2,23
114427,Wednesday,15,0,0,2,17
114427,Wednesday,14,0,0,1,15
114428,Wednesday,14,0,0,5,19
114428,Wednesday,22,0,0,0,22
114428,Wednesday,15,0,0,1,16
114428,Wednesday,26,1,0,2,29
114429,Wednesday,19,0,0,2,21
114429,Wednesday,19,0,0,1,20
114429,Wednesday,24,0,0,2,26
114430,Wednesday,20,0,0,2,22
114430,Wednesday,20,0,1,4,25
114430,Wednesday,19,0,0,3,22
114430,Wednesday,19,0,0,3,22
114431,Wednesday,19,0,0,4,23
114431,Wednesday,21,0,0,0,21
114431,Wednesday,18,0,0,0,18
114431,Wednesday,20,0,0,2,22
114432,Wednesday,21,0,0,0,21
114432,Wednesday,18,0,0,3,21
114432,Wednesday,20,0,0,2,22
114433,Wednesday,19,0,1,4,24
114433,Wednesday,20,0,0,2,22
114433,Wednesday,22,0,0,2,24
114433,Wednesday,24,0,0,0,24
114434,Wednesday,17,0,0,1,18
114434,Wednesday,18,0,0,3,21
114434,Wednesday,13,0,0,2,15
114434,Wednesday,19,0,0,0,19
114435,Wednesday,25,0,0,0,25
114435,Wednesday,22,0,0,1,23
114435,Wednesday,26,0,0,2,28
114436,Wednesday,21,0,0,2,23
114436,Wednesday,18,0,0,1,19
114436,Wednesday,14,0,0,1,15
114436,Wednesday,15,0,0,2,17
114437,Wednesday,19,0,0,3,22
114437,Wednesday,19,0,0,2,21
114437,Wednesday,21,0,0,1,22
114437,Wednesday,18,0,0,2,20
114438,Wednesday,25,0,0,1,26
114438,Wednesday,22,0,0,2,24
114438,Wednesday,21,0,0,2,23
114439,Wednesday,25,0,0,0,25
114439,Wednesday,18,0,0,2,20
114439,Wednesday,21,0,0,0,21
114439,Wednesday,24,0,0,0,24
114440,Wednesday,20,0,0,2,22
114440,Wednesday,16,0,0,2,18
114440,Wednesday,21,0,0,0,21
114440,Wednesday,17,0,0,1,18
114441,Wednesday,18,0,0,1,19
114441,Wednesday,21,0,0,2,23
114441,Wednesday,23,0,0,0,23
114442,Wednesday,17,0,0,0,17
114442,Wednesday,25,1,0,2,28
114442,Wednesday,23,0,0,2,25
114442,Wednesday,18,0,0,5,23
114443,Wednesday,22,0,0,2,24
114443,Wednesday,18,0,0,0,18
114443,Wednesday,20,0,0,2,22
114444,Wednesday,15,0,0,2,17
114444,Wednesday,20,0,0,2,22
114444,Wednesday,20,0,0,2,22
114444,Wednesday,16,0,0,2,18
114445,Wednesday,21,0,0,2,23
114445,Wednesday,18,0,0,0,18
114445,Wednesday,19,0,0,0,19
114446,Wednesday,20,0,0,2,22
114446,Wednesday,17,0,0,0,17
114446,Wednesday,18,0,1,2,21
114446,Wednesday,17,0,0,1,18
114447,Wednesday,18,0,0,1,19
114447,Wednesday,19,0,0,0,19
114447,Wednesday,24,0,0,0,24
114447,Wednesday,21,0,0,0,21
114448,Wednesday,20,0,1,2,23
114448,Wednesday,18,0,0,2,20
114448,Wednesday,26,0,0,0,26
114449,Wednesday,23,0,0,0,23
114449,Wednesday,17,0,0,2,19
114449,Wednesday,23,0,0,1,24
114449,Wednesday,20,0,1,3,24
114450,Wednesday,13,0,1,2,16
114450,Wednesday,18,0,0,0,18
114450,Wednesday,16,0,0,1,17
114450,Wednesday,21,0,0,1,22
114451,Wednesday,22,0,0,2,24
114451,Wednesday,24,0,0,1,25
114451,Wednesday,25,0,0,0,25
114452,Wednesday,20,0,0,3,23
114452,Wednesday,17,0,0,3,20
114452,Wednesday,16,0,0,2,18
114452,Wednesday,15,0,0,2,17
114453,Wednesday,19,0,0,1,20
114453,Wednesday,19,0,0,2,21
114453,Wednesday,27,0,0,1,28
114453,Wednesday,23,0,0,0,23
114454,Wednesday,19,0,0,1,20
114454,Wednesday,21,0,0,3,24
114454,Wednesday,20,0,0,2,22
114455,Wednesday,17,0,0,2,19
114455,Wednesday,21,0,0,1,22
114455,Wednesday,18,0,0,3,21
114455,Wednesday,23,1,0,2,26
114456,Wednesday,16,0,0,2,18
114456,Wednesday,25,0,0,0,25
114456,Wednesday,21,0,0,0,21
114456,Wednesday,17,0,0,3,20
114457,Wednesday,13,0,0,2,15
114457,Wednesday,22,0,0,2,24
114457,Wednesday,19,0,0,2,21
114458,Wednesday,19,0,0,3,22
114458,Wednesday,20,0,0,2,22
114458,Wednesday,17,0,0,1,18
114458,Wednesday,15,0,0,0,15
114459,Wednesday,21,0,0,0,21
114459,Wednesday,23,0,0,0,23
114459,Wednesday,23,0,0,2,25
114500,Wednesday,24,1,0,1,26
114500,Wednesday,23,0,0,0,23
114500,Wednesday,16,0,0,2,18
114500,Wednesday,14,0,0,1,15
114501,Wednesday,18,0,0,2,20
114501,Wednesday,22,0,0,0,22
114501,Wednesday,22,0,0,0,22
114501,Wednesday,26,0,0,2,28
114502,Wednesday,21,0,0,0,21
114502,Wednesday,24,0,0,2,26
114502,Wednesday,22,0,0,2,24
114503,Wednesday,17,0,0,6,23
114503,Wednesday,15,0,0,3,18
114503,Wednesday,16,0,0,1,17
114503,Wednesday,18,0,0,2,20
114504,Wednesday,17,0,0,2,19
114504,Wednesday,16,0,0,2,18
114504,Wednesday,22,0,0,2,24
114504,Wednesday,20,0,0,4,24
114505,Wednesday,25,0,0,0,25
114505,Wednesday,24,0,0,0,24
114505,Wednesday,22,0,0,0,22
114506,Wednesday,24,0,0,0,24
114506,Wednesday,18,0,0,3,21
114506,Wednesday,15,0,0,2,17
114506,Wednesday,14,0,0,1,15
114507,Wednesday,25,1,0,1,27
114507,Wednesday,18,0,0,1,19
114507,Wednesday,18,0,0,1,19
114507,Wednesday,15,0,0,2,17
114508,Wednesday,14,0,0,3,17
114508,Wednesday,20,0,1,4,25
114508,Wednesday,22,0,0,1,23
114509,Wednesday,18,0,0,1,19
114509,Wednesday,17,0,0,2,19
114509,Wednesday,25,0,0,0,25
114509,Wednesday,19,0,0,0,19
114510,Wednesday,13,0,0,1,14
114510,Wednesday,21,0,0,2,23
114510,Wednesday,22,0,0,3,25
114511,Wednesday,26,0,0,0,26
114511,Wednesday,20,0,0,0,20
114511,Wednesday,26,0,0,0,26
114511,Wednesday,24,0,0,0,24
114512,Wednesday,19,0,0,2,21
114512,Wednesday,22,0,0,0,22
114512,Wednesday,21,0,0,2,23
114512,Wednesday,25,0,0,0,25
114513,Wednesday,13,0,0,2,15
114513,Wednesday,18,0,0,3,21
114513,Wednesday,15,0,0,2,17
114514,Wednesday,22,0,0,0,22
114514,Wednesday,23,0,0,2,25
114514,Wednesday,18,0,0,2,20
114514,Wednesday,17,0,0,3,20
114515,Wednesday,20,0,0,3,23
114515,Wednesday,22,0,0,2,24
114515,Wednesday,15,0,0,2,17
114516,Wednesday,22,0,0,0,22
114516,Wednesday,24,0,0,1,25
114516,Wednesday,19,0,0,2,21
114516,Wednesday,17,0,0,2,19
114517,Wednesday,18,0,0,3,21
114517,Wednesday,26,0,0,1,27
114517,Wednesday,17,0,0,2,19
114517,Wednesday,28,0,0,0,28
114518,Wednesday,15,0,0,3,18
114518,Wednesday,26,0,0,1,27
114518,Wednesday,19,0,0,0,19
114519,Wednesday,18,0,0,3,21
114519,Wednesday,20,0,0,3,23
114519,Wednesday,18,0,0,3,21
114519,Wednesday,23,0,0,0,23
114520,Wednesday,18,0,0,2,20
114520,Wednesday,22,0,0,0,22
114520,Wednesday,21,0,0,2,23
114521,Wednesday,26,0,0,1,27
114521,Wednesday,13,0,0,3,16
114521,Wednesday,24,0,0,0,24
114521,Wednesday,14,0,0,2,16
114522,Wednesday,24,0,0,2,26
114522,Wednesday,19,0,0,2,21
114522,Wednesday,18,0,0,3,21
114522,Wednesday,18,0,0,3,21
114523,Wednesday,20,0,0,0,20
114523,Wednesday,17,0,0,3,20
114523,Wednesday,24,0,0,0,24
114524,Wednesday,18,0,0,3,21
114524,Wednesday,21,0,0,0,21
114524,Wednesday,21,0,0,2,23
114524,Wednesday,20,0,0,2,22
114525,Wednesday,26,0,0,1,27
114525,Wednesday,17,0,0,2,19
114525,Wednesday,26,1,0,2,29
114525,Wednesday,21,0,0,2,23
114526,Wednesday,19,0,0,3,22
114526,Wednesday,19,0,1,2,22
114526,Wednesday,21,0,0,0,21
114527,Wednesday,18,0,0,1,19
114527,Wednesday,22,0,0,0,22
114527,Wednesday,22,0,0,2,24
114527,Wednesday,17,0,0,3,20
114528,Wednesday,23,0,0,0,23
114528,Wednesday,22,0,0,0,22
114528,Wednesday,22,0,0,0,22
114528,Wednesday,23,0,0,0,23
114529,Wednesday,15,0,0,2,17
114529,Wednesday,14,0,0,1,15
114529,Wednesday,19,0,0,3,22
114530,Wednesday,22,0,0,2,24
114530,Wednesday,20,0,0,1,21
114530,Wednesday,18,0,0,0,18
114530,Wednesday,14,0,0,1,15
114531,Wednesday,19,0,0,2,21
114531,Wednesday,18,0,0,1,19
114531,Wednesday,22,0,0,2,24
114532,Wednesday,16,0,0,4,20
114532,Wednesday,21,0,0,1,22
114532,Wednesday,24,0,0,0,24
114532,Wednesday,22,0,0,2,24
114533,Wednesday,20,0,0,1,21
114533,Wednesday,25,0,0,0,25
114533,Wednesday,24,0,0,2,26
114533,Wednesday,19,0,0,1,20
114534,Wednesday,23,0,0,0,23
114534,Wednesday,17,0,0,3,20
114534,Wednesday,20,0,0,2,22
114534,Wednesday,14,0,0,1,15
114535,Wednesday,15,0,0,1,16
114535,Wednesday,19,0,0,2,21
114535,Wednesday,23,0,0,1,24
114536,Wednesday,15,0,0,1,16
114536,Wednesday,13,0,0,3,16
114536,Wednesday,25,0,0,0,25
114536,Wednesday,23,0,0,2,25
114537,Wednesday,16,0,0,2,18
114537,Wednesday,20,0,0,0,20
114537,Wednesday,22,0,0,0,22
114537,Wednesday,23,0,0,2,25
114538,Wednesday,15,0,0,5,20
114538,Wednesday,24,0,0,0,24
114538,Wednesday,17,0,0,5,22
114539,Wednesday,18,0,0,1,19
114539,Wednesday,20,0,0,2,22
114539,Wednesday,16,0,1,1,18
114539,Wednesday,14,0,0,3,17
114540,Wednesday,22,0,0,2,24
114540,Wednesday,21,0,0,0,21
114540,Wednesday,18,0,0,2,20
114541,Wednesday,24,0,0,0,24
114541,Wednesday,18,0,0,1,19
114541,Wednesday,14,0,0,2,16
114541,Wednesday,22,0,0,2,24
114542,Wednesday,20,0,0,2,22
114542,Wednesday,22,0,0,0,22
114542,Wednesday,20,0,0,2,22
114542,Wednesday,23,1,0,2,26
114543,Wednesday,20,0,0,2,22
114543,Wednesday,23,0,0,0,23
114543,Wednesday,20,0,0,3,23
114544,Wednesday,24,1,0,2,27
114544,Wednesday,18,0,0,1,19
114544,Wednesday,19,0,0,0,19
114544,Wednesday,15,0,0,2,17
114545,Wednesday,12,0,0,3,15
114545,Wednesday,23,0,0,0,23
114545,Wednesday,18,0,0,1,19
114546,Wednesday,22,0,0,0,22
114546,Wednesday,17,0,0,2,19
114546,Wednesday,16,0,0,2,18
114546,Wednesday,24,0,0,0,24
114547,Wednesday,20,0,0,2,22
114547,Wednesday,17,0,0,2,19
114547,Wednesday,22,0,0,1,23
114547,Wednesday,19,0,0,2,21
114548,Wednesday,16,0,0,3,19
114548,Wednesday,16,0,0,2,18
114548,Wednesday,17,0,0,2,19
114549,Wednesday,15,0,0,2,17
114549,Wednesday,19,0,0,0,19
114549,Wednesday,20,0,0,4,24
114549,Wednesday,15,0,0,3,18
114550,Wednesday,21,0,0,1,22
114550,Wednesday,17,0,0,1,18
114550,Wednesday,16,0,0,2,18
114550,Wednesday,18,0,0,2,20
114551,Wednesday,15,0,0,1,16
114551,Wednesday,24,0,0,0,24
114551,Wednesday,17,0,0,2,19
114552,Wednesday,21,0,1,3,25
114552,Wednesday,15,0,0,3,18
114552,Wednesday,26,0,0,2,28
114552,Wednesday,20,0,0,0,20
114553,Wednesday,24,1,0,0,25
114553,Wednesday,16,0,0,2,18
114553,Wednesday,26,0,0,2,28
114553,Wednesday,22,0,0,2,24
114554,Wednesday,22,0,0,2,24
114554,Wednesday,20,0,0,2,22
114554,Wednesday,23,0,0,0,23
114554,Wednesday,17,0,0,2,19
114555,Wednesday,18,0,0,1,19
114555,Wednesday,21,0,0,2,23
114555,Wednesday,14,0,0,2,16
114556,Wednesday,21,0,0,0,21
114556,Wednesday,18,0,0,2,20
114556,Wednesday,19,0,0,2,21
114556,Wednesday,18,0,0,3,21
114557,Wednesday,15,0,0,3,18
114557,Wednesday,19,0,0,4,23
114557,Wednesday,17,0,0,2,19
114557,Wednesday,22,0,0,0,22
114558,Wednesday,19,0,0,3,22
114558,Wednesday,20,0,0,0,20
114558,Wednesday,21,0,0,1,22
114558,Wednesday,24,0,0,0,24
114559,Wednesday,23,0,0,2,25
114559,Wednesday,24,0,0,0,24
114559,Wednesday,22,0,0,0,22
114600,Wednesday,19,0,0,2,21
114600,Wednesday,17,0,0,1,18
114600,Wednesday,20,0,0,0,20
114600,Wednesday,24,1,0,2,27
114601,Wednesday,14,0,0,2,16
114601,Wednesday,22,0,0,2,24
114601,Wednesday,20,0,0,2,22
114601,Wednesday,18,0,0,1,19
114602,Wednesday,21,0,0,1,22
114602,Wednesday,19,0,0,2,21
114602,Wednesday,21,0,0,0,21
114602,Wednesday,18,0,0,1,19
114603,Wednesday,22,0,0,0,22
114603,Wednesday,22,0,0,2,24
114603,Wednesday,19,0,0,2,21
114603,Wednesday,19,0,0,1,20
114604,Wednesday,17,0,0,2,19
114604,Wednesday,24,0,0,2,26
114604,Wednesday,19,0,0,4,23
114605,Wednesday,24,0,0,0,24
114605,Wednesday,21,0,0,0,21
114605,Wednesday,18,0,0,3,21
114605,Wednesday,14,0,0,3,17
114606,Wednesday,20,0,0,4,24
114606,Wednesday,21,0,0,0,21
114606,Wednesday,21,0,0,1,22
114606,Wednesday,14,0,0,1,15
114607,Wednesday,19,0,0,1,20
114607,Wednesday,15,0,0,3,18
114607,Wednesday,24,0,0,0,24
114607,Wednesday,25,0,0,2,27
114608,Wednesday,18,0,0,1,19
114608,Wednesday,18,0,0,1,19
114608,Wednesday,17,0,0,1,18
114609,Wednesday,21,0,0,2,23
114609,Wednesday,18,0,0,3,21
114609,Wednesday,13,0,0,3,16
114609,Wednesday,18,0,0,4,22
114610,Wednesday,17,0,0,3,20
114610,Wednesday,19,0,0,0,19
114610,Wednesday,21,0,0,0,21
114610,Wednesday,23,0,0,0,23
114611,Wednesday,19,0,0,2,21
114611,Wednesday,19,0,0,0,19
114611,Wednesday,18,0,0,2,20
114611,Wednesday,23,0,0,0,23
114612,Wednesday,18,0,0,0,18
114612,Wednesday,21,0,0,2,23
114612,Wednesday,26,0,0,2,28
114613,Wednesday,18,0,0,2,20
114613,Wednesday,22,0,0,0,22
114613,Wednesday,20,0,0,1,21
114613,Wednesday,14,0,0,2,16
114614,Wednesday,16,0,0,1,17
114614,Wednesday,24,0,0,2,26
114614,Wednesday,17,0,0,3,20
114614,Wednesday,24,0,0,0,24
114615,Wednesday,21,0,0,2,23
114615,Wednesday,17,0,0,1,18
114615,Wednesday,19,0,0,3,22
114615,Wednesday,27,0,0,2,29
114616,Wednesday,24,0,0,0,24
114616,Wednesday,19,0,0,2,21
114616,Wednesday,26,0,0,2,28
114617,Wednesday,26,0,0,0,26
114617,Wednesday,14,0,0,3,17
114617,Wednesday,18,0,0,1,19
114617,Wednesday,14,0,0,4,18
114618,Wednesday,23,0,0,2,25
114618,Wednesday,16,0,0,3,19
114618,Wednesday,20,0,0,0,20
114618,Wednesday,27,0,0,1,28
114619,Wednesday,20,0,0,1,21
114619,Wednesday,17,0,0,3,20
114619,Wednesday,18,0,0,1,19
114619,Wednesday,18,0,0,3,21
114620,Wednesday,14,0,0,3,17
114620,Wednesday,17,0,0,2,19
114620,Wednesday,21,0,0,2,23
114621,Wednesday,18,0,0,2,20
114621,Wednesday,25,0,0,1,26
114621,Wednesday,20,0,0,2,22
114621,Wednesday,16,0,0,2,18
114622,Wednesday,24,0,0,0,24
114622,Wednesday,15,0,0,3,18
114622,Wednesday,21,0,0,2,23
114622,Wednesday,17,0,0,3,20
114623,Wednesday,24,0,0,0,24
114623,Wednesday,17,0,0,1,18
114623,Wednesday,18,0,0,2,20
114623,Wednesday,26,0,0,1,27
114624,Wednesday,17,0,0,3,20
114624,Wednesday,19,0,0,0,19
114624,Wednesday,25,0,0,0,25
114625,Wednesday,20,0,0,3,23
114625,Wednesday,20,0,0,2,22
114625,Wednesday,15,0,0,3,18
114625,Wednesday,19,0,0,1,20
114626,Wednesday,22,0,0,2,24
114626,Wednesday,24,0,0,1,25
114626,Wednesday,21,0,0,2,23
114626,Wednesday,23,0,0,1,24
114627,Wednesday,24,0,0,2,26
114627,Wednesday,21,0,0,1,22
114627,Wednesday,19,0,0,1,20
114627,Wednesday,19,0,0,0,19
114628,Wednesday,22,0,0,0,22
114628,Wednesday,25,0,0,0,25
114628,Wednesday,19,0,0,3,22
114629,Wednesday,26,0,0,0,26
114629,Wednesday,22,0,0,1,23
114629,Wednesday,15,0,0,2,17
114629,Wednesday,25,0,0,0,25
114630,Wednesday,19,0,0,1,20
114630,Wednesday,23,0,0,0,23
114630,Wednesday,24,0,0,1,25
114630,Wednesday,26,0,0,0,26
114631,Wednesday,23,0,0,2,25
114631,Wednesday,18,0,0,3,21
114631,Wednesday,24,1,0,0,25
114631,Wednesday,18,0,0,1,19
114632,Wednesday,22,0,0,0,22
114632,Wednesday,15,0,0,3,18
114632,Wednesday,20,0,0,3,23
114633,Wednesday,24,0,0,1,25
114633,Wednesday,20,0,0,2,22
114633,Wednesday,19,0,0,2,21
114633,Wednesday,18,0,0,3,21
114634,Wednesday,21,0,0,1,22
114634,Wednesday,21,0,0,2,23
114634,Wednesday,14,0,0,1,15
114634,Wednesday,16,0,0,2,18
114635,Wednesday,24,0,0,2,26
114635,Wednesday,22,0,0,2,24
114635,Wednesday,23,0,0,0,23
114635,Wednesday,16,0,0,4,20
114636,Wednesday,15,0,0,3,18
114636,Wednesday,23,1,0,1,25
114636,Wednesday,22,0,0,0,22
114636,Wednesday,20,0,1,0,21
114637,Wednesday,23,0,0,2,25
114637,Wednesday,23,0,0,1,24
114637,Wednesday,24,0,0,0,24
114638,Wednesday,21,0,0,2,23
114638,Wednesday,16,0,0,4,20
114638,Wednesday,21,0,0,0,21
114638,Wednesday,26,0,0,1,27
114639,Wednesday,25,0,0,0,25
114639,Wednesday,26,0,0,0,26
114639,Wednesday,17,0,0,3,20
114639,Wednesday,15,0,0,2,17
114640,Wednesday,20,0,0,0,20
114640,Wednesday,17,0,0,2,19
114640,Wednesday,20,0,0,1,21
114640,Wednesday,22,0,0,0,22
114641,Wednesday,22,0,0,1,23
114641,Wednesday,23,0,0,1,24
114641,Wednesday,20,0,0,1,21
114642,Wednesday,22,0,0,0,22
114642,Wednesday,25,0,0,1,26
114642,Wednesday,23,0,0,0,23
114642,Wednesday,13,0,0,2,15
114643,Wednesday,21,0,1,4,26
114643,Wednesday,25,0,0,0,25
114643,Wednesday,14,0,0,2,16
114643,Wednesday,23,0,0,0,23
114644,Wednesday,17,0,0,2,19
114644,Wednesday,14,0,0,2,16
114644,Wednesday,16,0,0,3,19
114645,Wednesday,16,0,0,2,18
114645,Wednesday,22,0,0,0,22
114645,Wednesday,21,0,0,1,22
114645,Wednesday,16,0,0,3,19
114646,Wednesday,25,0,0,0,25
114646,Wednesday,18,0,0,3,21
114646,Wednesday,23,0,0,0,23
114646,Wednesday,19,0,0,3,22
114647,Wednesday,23,0,0,2,25
114647,Wednesday,14,0,0,3,17
114647,Wednesday,25,0,0,0,25
114648,Wednesday,16,0,0,2,18
114648,Wednesday,19,0,0,2,21
114648,Wednesday,21,0,0,2,23
114648,Wednesday,14,0,0,6,20
114649,Wednesday,15,0,0,2,17
114649,Wednesday,19,0,0,0,19
114649,Wednesday,22,0,0,0,22
114649,Wednesday,19,0,0,4,23
114650,Wednesday,19,0,0,4,23
114650,Wednesday,20,0,1,1,22
114650,Wednesday,22,0,0,0,22
114651,Wednesday,23,0,0,2,25
114651,Wednesday,15,0,0,4,19
114651,Wednesday,22,0,0,2,24
114651,Wednesday,20,0,0,3,23
114652,Wednesday,14,0,0,2,16
114652,Wednesday,18,0,0,2,20
114652,Wednesday,22,0,0,1,23
114652,Wednesday,19,0,0,4,23
114653,Wednesday,16,0,0,2,18
114653,Wednesday,15,0,0,2,17
114653,Wednesday,16,0,0,2,18
114654,Wednesday,26,0,0,0,26
114654,Wednesday,19,0,0,3,22
114654,Wednesday,15,0,0,4,19
114654,Wednesday,17,0,0,3,20
114655,Wednesday,19,0,0,2,21
114655,Wednesday,18,0,0,3,21
114655,Wednesday,18,0,0,3,21
114655,Wednesday,16,0,0,2,18
114656,Wednesday,19,0,0,0,19
114656,Wednesday,21,0,0,1,22
114656,Wednesday,21,0,0,2,23
114657,Wednesday,19,0,0,3,22
114657,Wednesday,13,0,0,1,14
114657,Wednesday,23,0,0,0,23
114657,Wednesday,18,0,0,2,20
114658,Wednesday,23,0,0,2,25
114658,Wednesday,22,0,0,2,24
114658,Wednesday,17,0,0,0,17
114658,Wednesday,22,0,0,0,22
114659,Wednesday,24,0,0,0,24
114659,Wednesday,23,0,0,2,25
114659,Wednesday,15,0,0,5,20
114659,Wednesday,19,0,0,1,20
114700,Wednesday,24,0,0,1,25
114700,Wednesday,17,0,0,3,20
114700,Wednesday,20,0,0,2,22
114701,Wednesday,17,0,1,2,20
114701,Wednesday,16,0,0,2,18
114701,Wednesday,22,0,0,2,24
114701,Wednesday,16,0,0,2,18
114702,Wednesday,25,0,0,0,25
114702,Wednesday,21,0,0,2,23
114702,Wednesday,15,0,0,2,17
114702,Wednesday,17,0,0,1,18
114703,Wednesday,25,0,0,0,25
114703,Wednesday,18,0,0,2,20
114703,Wednesday,23,0,0,2,25
114703,Wednesday,20,0,0,3,23
114704,Wednesday,15,0,0,2,17
114704,Wednesday,21,0,0,1,22
114704,Wednesday,16,0,0,3,19
114705,Wednesday,21,0,0,0,21
114705,Wednesday,16,0,0,2,18
114705,Wednesday,16,0,0,2,18
114705,Wednesday,23,0,0,2,25
114706,Wednesday,15,0,0,1,16
114706,Wednesday,24,0,0,0,24
114706,Wednesday,19,0,0,3,22
114706,Wednesday,16,0,0,2,18
114707,Wednesday,24,0,0,0,24
114707,Wednesday,20,0,1,1,22
114707,Wednesday,20,0,0,2,22
114707,Wednesday,23,1,0,2,26
114708,Wednesday,20,0,1,1,22
114708,Wednesday,17,0,0,2,19
114708,Wednesday,21,0,0,0,21
114709,Wednesday,23,1,0,0,24
114709,Wednesday,22,0,0,2,24
114709,Wednesday,23,0,0,0,23
114709,Wednesday,18,0,0,1,19
114710,Wednesday,17,0,0,0,17
114710,Wednesday,21,0,0,0,21
114710,Wednesday,15,0,0,2,17
114710,Wednesday,20,0,0,2,22
114711,Wednesday,14,0,0,1,15
114711,Wednesday,17,0,0,3,20
114711,Wednesday,22,0,0,2,24
114712,Wednesday,18,0,0,5,23
114712,Wednesday,19,0,0,0,19
114712,Wednesday,26,0,0,0,26
114712,Wednesday,19,0,0,0,19
114713,Wednesday,21,0,0,2,23
114713,Wednesday,20,0,0,3,23
114713,Wednesday,18,0,0,1,19
114713,Wednesday,26,0,0,1,27
114714,Wednesday,19,0,0,1,20
114714,Wednesday,16,0,0,2,18
114714,Wednesday,22,0,0,2,24
114714,Wednesday,22,0,0,2,24
114715,Wednesday,25,0,0,0,25
114715,Wednesday,17,0,0,2,19
114715,Wednesday,18,0,0,2,20
114716,Wednesday,16,0,0,4,20
114716,Wednesday,22,0,0,2,24
114716,Wednesday,21,0,0,2,23
114716,Wednesday,15,0,0,2,17
114717,Wednesday,18,0,0,2,20
114717,Wednesday,20,0,0,2,22
114717,Wednesday,14,0,0,2,16
114717,Wednesday,22,0,0,1,23
114718,Wednesday,14,0,0,0,14
114718,Wednesday,25,0,0,0,25
114718,Wednesday,18,0,0,3,21
114718,Wednesday,21,0,1,2,24
114719,Wednesday,14,0,0,3,17
114719,Wednesday,17,0,0,2,19
114719,Wednesday,22,0,0,2,24
114720,Wednesday,24,0,0,1,25
114720,Wednesday,23,0,0,2,25
114720,Wednesday,23,0,0,0,23
114720,Wednesday,21,0,0,1,22
114721,Wednesday,14,0,0,2,16
114721,Wednesday,21,0,1,1,23
114721,Wednesday,22,0,0,0,22
114721,Wednesday,22,0,0,0,22
114722,Wednesday,23,0,0,2,25
114722,Wednesday,21,0,0,0,21
114722,Wednesday,19,0,0,3,22
114722,Wednesday,25,0,0,0,25
114723,Wednesday,18,0,0,0,18
114723,Wednesday,18,0,0,1,19
114723,Wednesday,18,0,0,2,20
114724,Wednesday,18,0,0,3,21
114724,Wednesday,20,0,0,1,21
114724,Wednesday,22,0,0,0,22
114724,Wednesday,20,0,2,1,23
114725,Wednesday,25,0,0,0,25
114725,Wednesday,26,0,0,1,27
114725,Wednesday,21,0,0,1,22
114725,Wednesday,20,0,1,4,25
114726,Wednesday,17,0,0,1,18
114726,Wednesday,18,0,0,3,21
114726,Wednesday,17,0,0,2,19
114727,Wednesday,15,0,0,3,18
114727,Wednesday,20,0,0,3,23
114727,Wednesday,16,0,0,2,18
114727,Wednesday,20,0,0,0,20
114728,Wednesday,24,0,0,1,25
114728,Wednesday,17,0,0,2,19
114728,Wednesday,15,0,0,0,15
114728,Wednesday,22,0,0,0,22
114729,Wednesday,19,0,0,4,23
114729,Wednesday,21,0,0,3,24
114729,Wednesday,20,0,0,2,22
114730,Wednesday,18,0,0,4,22
114730,Wednesday,19,0,0,1,20
114730,Wednesday,24,0,0,2,26
114730,Wednesday,22,0,0,0,22
114731,Wednesday,20,0,0,1,21
114731,Wednesday,19,0,0,2,21
114731,Wednesday,14,0,0,1,15
114731,Wednesday,25,1,0,2,28
114732,Wednesday,20,0,0,2,22
114732,Wednesday,19,0,0,3,22
114732,Wednesday,20,0,0,2,22
114732,Wednesday,15,0,0,3,18
114733,Wednesday,14,0,0,2,16
114733,Wednesday,17,0,0,1,18
114733,Wednesday,22,0,0,2,24
114733,Wednesday,21,0,0,3,24
114734,Wednesday,23,0,0,0,23
114734,Wednesday,19,0,0,1,20
114734,Wednesday,24,0,0,0,24
114735,Wednesday,22,0,0,1,23
114735,Wednesday,20,0,0,2,22
114735,Wednesday,19,0,0,1,20
114735,Wednesday,26,0,0,2,28
114736,Wednesday,18,0,0,3,21
114736,Wednesday,16,0,0,1,17
114736,Wednesday,16,0,0,3,19
114736,Wednesday,21,0,0,2,23
114737,Wednesday,19,0,0,1,20
114737,Wednesday,19,0,0,1,20
114737,Wednesday,17,0,0,0,17
114737,Wednesday,20,0,0,0,20
114738,Wednesday,15,0,0,2,17
114738,Wednesday,15,0,0,4,19
114738,Wednesday,15,0,0,2,17
114739,Wednesday,15,0,0,2,17
114739,Wednesday,13,0,0,1,14
114739,Wednesday,14,0,0,2,16
114739,Wednesday,17,0,0,2,19
114740,Wednesday,23,0,0,2,25
114740,Wednesday,21,0,0,3,24
114740,Wednesday,26,0,0,1,27
114740,Wednesday,23,0,0,3,26
114741,Wednesday,27,0,0,0,27
114741,Wednesday,23,0,0,0,23
114741,Wednesday,22,0,0,2,24
114741,Wednesday,21,0,0,1,22
114742,Wednesday,21,0,0,3,24
114742,Wednesday,22,0,0,3,25
114742,Wednesday,18,0,0,0,18
114743,Wednesday,19,0,0,2,21
114743,Wednesday,22,0,0,2,24
114743,Wednesday,16,0,0,1,17
114743,Wednesday,19,0,0,3,22
114744,Wednesday,25,0,0,0,25
114744,Wednesday,19,0,0,4,23
114744,Wednesday,21,0,0,0,21
114744,Wednesday,22,0,0,0,22
114745,Wednesday,21,0,1,0,22
114745,Wednesday,14,0,0,2,16
114745,Wednesday,20,0,0,1,21
114745,Wednesday,13,0,0,2,15
114746,Wednesday,24,0,0,0,24
114746,Wednesday,22,0,0,0,22
114746,Wednesday,18,0,0,1,19
114747,Wednesday,21,0,0,0,21
114747,Wednesday,20,0,0,1,21
114747,Wednesday,18,0,0,1,19
114747,Wednesday,25,0,0,0,25
114748,Wednesday,15,0,0,2,17
114748,Wednesday,17,0,0,1,18
114748,Wednesday,16,0,0,3,19
114749,Wednesday,20,0,0,2,22
114749,Wednesday,20,0,0,3,23
114749,Wednesday,18,0,0,0,18
114749,Wednesday,20,0,0,3,23
114750,Wednesday,21,0,0,1,22
114750,Wednesday,20,0,1,1,22
114751,Wednesday,18,0,0,1,19
114751,Wednesday,24,0,0,1,25
114752,Wednesday,21,0,0,2,23
114753,Wednesday,15,0,0,4,19
114753,Wednesday,19,0,0,3,22
114754,Wednesday,21,0,0,0,21
114754,Wednesday,21,0,0,0,21
114755,Wednesday,26,1,0,2,29
114755,Wednesday,23,0,0,0,23
114755,Wednesday,13,0,0,3,16
114756,Wednesday,15,0,0,1,16
114756,Wednesday,21,0,0,2,23
114757,Wednesday,19,0,0,2,21
114757,Wednesday,16,0,0,1,17
114758,Wednesday,26,0,0,0,26
114758,Wednesday,15,0,0,3,18
114758,Wednesday,14,0,0,1,15
114759,Wednesday,17,0,0,1,18
114759,Wednesday,23,0,0,2,25
114800,Wednesday,21,0,0,0,21
114800,Wednesday,23,0,0,0,23
114801,Wednesday,18,0,0,0,18
114801,Wednesday,17,0,0,2,19
114801,Wednesday,21,0,0,2,23
114802,Wednesday,18,0,0,2,20
114802,Wednesday,17,0,0,2,19
114803,Wednesday,17,0,0,1,18
114803,Wednesday,14,0,0,3,17
114803,Wednesday,16,0,0,1,17
114804,Wednesday,19,0,0,4,23
114804,Wednesday,22,0,0,3,25
114804,Wednesday,21,0,0,2,23
114805,Wednesday,17,0,0,1,18
114805,Wednesday,17,0,0,1,18
114805,Wednesday,20,0,0,2,22
114806,Wednesday,18,0,0,2,20
114806,Wednesday,20,0,0,2,22
114807,Wednesday,20,0,0,3,23
114807,Wednesday,18,0,0,2,20
114807,Wednesday,20,0,0,0,20
114808,Wednesday,24,0,0,0,24
114808,Wednesday,20,0,0,0,20
114808,Wednesday,15,0,0,2,17
114809,Wednesday,18,0,0,1,19
114809,Wednesday,16,0,0,5,21
114809,Wednesday,18,0,0,1,19
114810,Wednesday,19,0,0,1,20
114810,Wednesday,22,0,0,3,25
114811,Wednesday,21,0,0,1,22
114811,Wednesday,20,0,0,0,20
114811,Wednesday,22,0,0,1,23
114812,Wednesday,19,0,0,0,19
114812,Wednesday,15,0,0,2,17
114812,Wednesday,24,0,0,0,24
114813,Wednesday,24,0,0,2,26
114813,Wednesday,17,0,0,2,19
114813,Wednesday,20,0,0,2,22
114814,Wednesday,17,0,0,2,19
114814,Wednesday,21,0,1,4,26
114814,Wednesday,21,0,2,2,25
114815,Wednesday,21,0,0,2,23
114815,Wednesday,18,0,0,0,18
114815,Wednesday,17,0,0,4,21
114816,Wednesday,22,0,0,2,24
114816,Wednesday,16,0,0,3,19
114816,Wednesday,18,0,0,0,18
114817,Wednesday,21,0,0,2,23
114817,Wednesday,25,0,0,0,25
114817,Wednesday,21,0,0,1,22
114818,Wednesday,18,0,0,3,21
114818,Wednesday,24,0,0,1,25
114819,Wednesday,17,0,0,2,19
114819,Wednesday,22,0,0,0,22
114820,Wednesday,14,0,0,2,16
114820,Wednesday,16,0,0,1,17
114820,Wednesday,20,0,0,1,21
114821,Wednesday,24,0,0,0,24
114821,Wednesday,15,0,0,4,19
114821,Wednesday,16,0,0,2,18
114822,Wednesday,15,0,0,3,18
114822,Wednesday,23,0,0,3,26
114823,Wednesday,18,0,0,2,20
114823,Wednesday,15,0,0,2,17
114824,Wednesday,15,0,0,2,17
114824,Wednesday,21,0,0,0,21
114824,Wednesday,23,0,0,0,23
114825,Wednesday,18,0,0,0,18
114825,Wednesday,16,0,0,1,17
114825,Wednesday,19,0,0,2,21
114826,Wednesday,15,0,0,1,16
114826,Wednesday,24,0,0,0,24
114826,Wednesday,16,0,0,3,19
114827,Wednesday,17,0,1,2,20
114827,Wednesday,18,0,0,2,20
114827,Wednesday,16,0,0,1,17
114828,Wednesday,26,0,0,0,26
114828,Wednesday,21,0,0,0,21
114829,Wednesday,19,0,0,3,22
114829,Wednesday,26,0,0,0,26
114829,Wednesday,18,0,0,1,19
114830,Wednesday,20,0,0,2,22
114830,Wednesday,13,0,0,3,16
114830,Wednesday,21,0,0,3,24
114831,Wednesday,21,0,0,3,24
114831,Wednesday,18,0,0,2,20
114831,Wednesday,20,0,0,0,20
114832,Wednesday,23,0,0,2,25
114832,Wednesday,20,0,0,1,21
114832,Wednesday,22,0,0,2,24
114833,Wednesday,16,0,0,2,18
114833,Wednesday,24,0,0,2,26
114833,Wednesday,23,0,0,2,25
114834,Wednesday,23,0,0,0,23
114834,Wednesday,17,0,0,2,19
114834,Wednesday,14,0,0,2,16
114835,Wednesday,24,0,0,2,26
114835,Wednesday,14,0,0,1,15
114835,Wednesday,22,0,0,1,23
114836,Wednesday,24,0,0,0,24
114836,Wednesday,17,0,0,2,19
114836,Wednesday,27,0,0,1,28
114837,Wednesday,27,0,0,0,27
114837,Wednesday,19,0,0,0,19
114837,Wednesday,24,0,0,2,26
114838,Wednesday,20,0,0,1,21
114838,Wednesday,14,0,0,2,16
114838,Wednesday,25,0,0,0,25
114839,Wednesday,16,0,0,2,18
114839,Wednesday,16,0,0,1,17
114839,Wednesday,22,0,0,0,22
114839,Wednesday,14,0,0,3,17
114840,Wednesday,16,0,0,2,18
114840,Wednesday,16,0,0,2,18
114840,Wednesday,22,0,0,0,22
114841,Wednesday,26,0,0,2,28
114841,Wednesday,20,0,0,3,23
114841,Wednesday,16,0,0,1,17
114841,Wednesday,18,0,0,2,20
